free encyclopedia|NN jump|NN navigation|NN jump|NN search|NN Alcoholic liver disease|Disease name|NN Alcoholic liver disease|Disease alcoholic hepatitisjpg microscopy|NN liver|NN show fatty change|NN cell|NN necrosis|NN mallory|NP body|NN
Alcoholic liver disease|Disease term|NN encompass liver|NN manifestation|NN alcohol|NN fatty liver|NN alcoholic hepatitis|NN chronic hepatitis|NN liver|NN fibrosis|NN cirrhosis|NN
major cause|NN liver|NN disease|NN western country|NN
fatty liver|NN develop individual|NN consume large quantity|NN alcoholic beverage|NN long period|NN time|NN process|NN transient reversible heavy drinker|NN develop fatty liver|NN well develop severe alcoholic hepatitis|NN cirrhosis|NN content|NN
risk|NN factor|NN fatty change|NN alcoholic hepatitis|NN diagnosis|NN laboratory|NN find|NN treatment|NN reference|NN further read|NN external link|NN
risk|NN factor|NN
risk|NN factor|NN presently known
quantity|NN alcohol|NN taken consumption|NN 6080g|NN day|NN 14g|NN consider standard drink|NN ie fl|NN oz|NN hard liquor|NN fl|NN oz|NN wine|NN fl|NN oz|NN beer|NN drink six-pack|NN beer|NN daily|NN middle|NN range|NN year|NN men|NN 20gday|NN women|NN significantly increase risk|NN hepatitis|NN fibrosis|NN pattern|NN drink|NN drink|NN outside|NN meal|NN time|NN increase time|NN risk|NN Alcoholic liver disease|Disease sex|NN women|NN twice susceptible alcohol-relate liver|NN disease|NN develop Alcoholic liver disease|Disease shorter duration|NN dose|NN chronic consumption|NN
lesser amount|NN alcohol|NN dehydrogenase|NN secret gut|NN higher proportion|NN body|NN fat|NN women|NN change|NN fat absorption|NN due menstrual cycle|NN explain phenomenon|NN hepatitis|NN c|NP infection|NN concomitant hepatitis|NN c|NP infection|NN significantly accelerate process|NN liver|NN injury|NN genetic factor|NN genetic factor|NN predispose alcoholism|NN Alcoholic liver disease|Disease
monozygotic twin|NN likely alcoholics|NN develop liver|NN cirrhosis|NN dizygotic|NN twin|NN
polymorphism enzyme|NN involve metabolism|NN alcohol|NN aldh|NN mitochondrial dysfunction|NN cytokine|NN polymorphism|NN partly explain genetic component|NN
specific polymorphism|NN currently firmly link Alcoholic liver disease|Disease
iron|NN overload|NN diet|NN particularly vitamin|NN deficiency|NN worsen liver|NN damage|NN prevent regeneration|NN hepatocyte|NN
particularly concern|NN alcoholics|NN usually malnourish poor diet|NN anorexia|NN encephalopathy|NN
pathogenesis|NN alcohol|NN induce liver|NN injury|NN
mechanism|NN completely understood alcohol|NN pass|NN liver|NN detoxify
chronic consumption|NN alcohol|NN result|NN secretion|NN pro-inflammatory cytokine|NN oxidative stress|NN lipid peroxidation|NN acetaldehyde|NN toxicity|NN
factor|NN cause|NN inflammation|NN apoptosis|NN eventually fibrosis|NN liver|NN cell|NN
occur individual|NN unclear
additionally liver|NN tremendous capacity|NN regenerate even hepatocyte|NN dead continue function|NN normal fatty change|NN main article|NN fatty liver|NN
fatty change|NN accumulation|NN fatty acid|NN liver|NN cell|NN
seen fatty globule|NN microscope|NN
alcoholism|NN cause|NN development|NN large fatty globule|NN macro vesicular steatosis|NN liver|NN begin occur day|NN heavy drink|NN alcohol|NN metabolize alcohol|NN dehydrogenase|NN acetaldehyde|NN further metabolize dehydrogenase|NN acetic acid|NN finally oxidize carbon|NN dioxide|NN co|NN water|NN h|NP process|NN generate increase nadhnad ratio|NN
higher nadh|NN concentration|NN induce fatty acid|NN synthesis|NN decrease nad|NN level|NN result|NN decrease fatty acid|NN oxidation|NN
subsequently higher level|NN fatty acid|NN signal liver|NN cell|NN compound|NN glycerol|NN form|NN triglyceride|NN
triglyceride|NN accumulate result fatty liver|NN
alcoholic hepatitis|NN main article|NN alcoholic hepatitis|NN
alcoholic hepatitis|NN characterize inflammation|NN hepatocyte|NN
heavy drinker|NN develop alcoholic hepatitis|NN
development|NN hepatitis|NN directly relate dose|NN alcohol|NN people|NN seem prone reaction|NN
call alcoholic steato|NN necrosis|NN inflammation|NN appear predispose liver|NN fibrosis|NN
cytokine|NN il6|NN thought essential initiation|NN perpetuation|NN liver|NN injury|NN induce apoptosis|NN necrosis|NN
possible mechanism|NN increase activity|NN
increase intestinal permeability|NN due liver|NN disease|NN
facilitate absorption|NN gut-produce endotoxin|NN portal|NN circulation|NN
kupffer cell|NN liver|NN endotoxin|NN stimulate release|NN
trigger apoptotic pathway|NN activation|NN caspase|NN result cell|NN death|NN main article|NN
late stage|NN serious liver|NN disease|NN mark inflammation|NN swell|NN fibrosis|NN cellular harden|NN damage membrane|NN prevent detoxification|NN chemical|NN body|NN end|NN scare|NN necrosis|NN cell|NN death|NN
heavy drinker|NN develop cirrhosis|NN liver|NN
responsible fibrosis|NN stimulate collagen|NN deposition|NN hepatic stellate cell|NN production|NN oxidant|NN derive oxi-|NN cytochrome p-450|NN formation|NN acetaldehyde-protein adduct|NN damage cell|NN membrane|NN symptom|NN include jaundice|NN yellow liver|NN enlargement|NN pain|NN tenderness|NN structural change|NN damage liver|NN architecture|NN
total abstinence|NN alcohol|NN use|NN cirrhosis|NN eventually lead liver|NN failure|NN
late complication|NN cirrhosis|NN liver|NN failure|NN include portal|NN hypertension|NN high blood|NN pressure|NN portal|NN vein|NN due increase flow|NN resistance|NN damage liver|NN coagulation|NN disorder|NN due impair production|NN coagulation|NN factor|NN ascite|NN heavy abdominal swell due|NN buildup|NN fluid|NN tissue|NN complication|NN hepatic encephalopathy|NN hepatorenal syndrome|NN
result cause|NN alcohol|NN abuse|NN viral hepatitis|NN heavy exposure|NN toxin|NN alcohol|NN
late stage|NN cirrhosis|NN look similar medically regardless cause|NN
phenomenon|NN term final common pathway|NN disease|NN
fatty change|NN alcoholic hepatitis|NN abstinence|NN reversible
later stage|NN fibrosis|NN cirrhosis|NN tend irreversible usually contain abstinence|NN long period|NN time|NN
early stage|NN patient|NN exhibit|NN subtle abnormal physical find|NN
usually development|NN advance liver|NN disease|NN stigmata|NN chronic liver|NN disease|NN become apparent
early usually discover routine|NN health|NN examination|NN liver|NN enzyme|NN level|NN found elevate
usually reflect alcoholic hepatic steatosis|NN
steatosis inflammation|NN seen liver|NN biopsy|NN specimen|NN
histologic feature|NN ald|NN indistinguishable fatty liver|NN disease|NN
usually resolve discontinuation|NN alcohol|NN use|NN
continuation|NN alcohol|NN use|NN result higher risk|NN progression|NN liver|NN disease|NN cirrhosis|NN
patient|NN acute alcoholic hepatitis|NN clinical manifestation|NN include fever|NN jaundice|NN possible hepatic decompensation|NN hepatic encephalopathy|NN variceal bleed|NN ascite|NN present abdominal pain|NN unusual
occasionally patient|NN asymptomatic laboratory|NN find|NN
people|NN alcoholic hepatitis|NN serum|NN aspartate|NN aminotransferase|NN ast|NN alanine aminotransferase|NN alt|NP ratio|NN greater
ast|NP alt|NP level|NN alway
elevate ast|NN alt|NP ratio|NN due deficiency|NN phosphate|NN require alt|NP enzyme|NN synthetic pathway|NN
furthermore alcohol|NN injury|NN hepatic mitochondria|NN result|NN ast|NP release|NN
laboratory|NN find|NN include red blood|NN cell|NN mean corpuscular volume|NN elevation|NN serum|NN ggt|NP alkaline phosphatase|NN alk|NN bilirubin|NN level|NN
level|NN reduce alcoholic patient|NN due decrease intestinal absorption|NN increase bone|NN marrow|NN requirement|NN folate|NN presence|NN alcohol|NN increase urinary loss|NN
magnitude|NN white blood|NN cell|NN depletion|NN reflect severity|NN liver|NN injury|NN
feature|NN include mallory body|NN giant|NN mitochondria|NN hepatocyte|NN necrosis|NN neutrophil|NN infiltration|NN area|NN vein|NN
mallory body|NN present liver|NN disease|NN condensation cytokeratin component|NN hepatocyte|NN cytoplasm|NN contribute liver|NN injury|NN
patient|NN moderate severe alcoholic hepatitis|NN cirrhosis|NN identifiable biopsy|NN examination|NN time|NN diagnosis|NN treatment|NN
drink further alcohol|NN important part|NN treatment|NN people|NN chronic hcv infection|NN abstain alcohol|NN intake|NN due risk|NN rapid acceleration|NN liver|NN disease|NN
cochrane|NP review|NN find evidence|NN sufficient use|NN anabolic steroid|NN sometime use recommend severe liver|NN inflammation|NN present
investigate possible treatment|NN ambiguous result|NN review|NN claim benefit|NN methionine|NN disease|NN model|NN
effect|NN necrosis|NN factor|NN medication|NN unclear possibly harmful evidence|NN unclear propylthiouracil|NN result harm|NN
evidence|NN support supplemental nutrition|NN liver|NN disease|NN
rare case|NN liver|NN cirrhosis|NN reversible disease|NN process|NN remain mostly irreversible
liver|NN transplantation|NN remain definitive therapy|NN
today survival|NN liver|NN transplantation|NN similar people|NN ald|NN non-ald|NN
requirement|NN transplant|NN list|NN type|NN liver|NN disease|NN 6-month sobriety|NN prerequisite|NN psychiatric evaluation|NN rehabilitation|NN assistance|NN ie alcoholics|NN anonymous
citation|NN need specific requirement|NN vary transplant|NN center|NN
relapse alcohol|NN use|NN transplant|NN list|NN result|NN
possible institution|NN month|NN sobriety|NN
limit data|NN transplant|NN survival|NN patient|NN transplant acute alcoholic hepatitis|NN believe similar ald|NN alcoholic hepatitis|NN mdf|NN prognosis|NN
prognosis|NN people|NN ald|NN depend liver|NN histology|NN well cofactor|NN concomitant chronic viral hepatitis|NN
patient|NN alcoholic hepatitis|NN progression|NN liver|NN cirrhosis|NN occur year|NN eventually develop cirrhosis|NN
cessation|NN alcohol|NN use|NN normalization|NN histology|NN serum|NN liver|NN enzyme|NN level|NN previously note mdf|NN use predict short-term mortality|NN ie mdf|NN
associate spontaneous survival|NN 5065|NN corticosteroid therapy|NN mdf|NN associate spontaneous survival|NN model|NN liver|NN disease|NN score|NN found similar predictive accuracy|NN 30-day meld|NN 90-day meld|NN mortality|NN
liver|NN cirrhosis|NN develop consume g|NN alcohol|NN daily men|NN g|NN daily women|NN
even drink g|NN daily suffer serious alcohol-relate liver|NN injury|NN
nevertheless alcohol-relate mortality|NN lead cause|NN death|NN united|NP states|NP
worldwide mortality|NN estimate 150000 year|NN
