free encyclopedia|NN jump|NN navigation|NN jump|NN search|NN use|NN see Asthma|Disease disambiguation|NN
Asthma|Disease white plastic|NN tube|NN movable dial|NN front peak|NN flow|NN meter|NN use measure peak|NN expiratory flow|NN rate|NN important monitor|NN diagnose Asthma|Disease specialty|NN symptom|NN episode|NN wheez cough|NN chest|NN tightness|NN shortness|NN breath|NN duration|NN long term|NN cause|NN genetic environmental factor|NN risk factor|NN air|NN pollution|NN allergen|NN diagnostic method|NN base symptom|NN response|NN therapy|NN treatment|NN avoid trigger|NN inhal corticosteroid|NN salbutamol|NN frequency|NN death|NN
Asthma|Disease common long-term inflammatory disease|NN airway|NN lung|NN characterize variable|NN recure symptom|NN reversible airflow|NN obstruction|NN easily trigger symptom|NN include episode|NN wheez cough|NN chest|NN tightness|NN shortness|NN breath|NN occur time|NN day|NN time|NN week|NN person|NN become worse night|NN exercise|NN
Asthma|Disease thought cause combination|NN genetic environmental factor|NN environmental factor|NN include exposure|NN air|NN pollution|NN allergen|NN potential trigger|NN include medication|NN aspirin|NN beta|NN blocker|NN diagnosis|NN usually base pattern|NN symptom|NN response|NN therapy|NN time|NN Asthma|Disease classify frequency|NN symptom|NN force expiratory volume|NN second|NN peak|NN expiratory flow|NN rate|NN classify atopic|NN non-atopic|NN refer predisposition|NN develop type|NN hypersensitivity|NN reaction|NN
cure|NN Asthma|Disease symptom|NN prevent avoid trigger|NN allergen|NN irritant|NN use|NN inhal corticosteroid|NN beta|NN agonist|NN agent|NN use addition|NN inhal corticosteroid|NN Asthma|Disease symptom|NN remain uncontrol treatment|NN rapidly worsen symptom|NN usually inhal short-act beta-2|NN agonist|NN salbutamol|NN corticosteroid|NN taken mouth|NN severe case|NN intravenous corticosteroid|NN magnesium|NN hospitalization|NN require
people|NN globally Asthma|Disease cause death|NN occure develop world|NN begin childhood|NN rate|NN Asthma|Disease increase significantly Asthma|Disease recognize early ancient egypt|NP word|NN Asthma|Disease greek sthma|NN mean pant content|NN
sign|NN symptom|NN associate condition|NN cause|NN environmental genetic medical condition|NN diagnosis|NN classification|NN differential diagnosis|NN prevention|NN management|NN lifestyle|NN modification|NN alternative medicine|NN epidemiology|NN economics|NN history|NN reference|NN note|NN external link|NN
sign|NN symptom|NN
menu|NN sound|NN wheez|NN heard stethoscope|NN
problem|NN play file|NN
see media|NN help
Asthma|Disease characterize recurrent episode|NN wheez shortness|NN breath|NN chest|NN tightness|NN cough|NN sputum|NN produce lung|NN cough|NN hard bring recovery|NN attack|NN appear due|NN high level|NN white blood|NN cell|NN call eosinophil|NN symptom|NN usually worse night|NN early morn|NN response|NN exercise|NN cold air|NN people|NN Asthma|Disease rarely experience|NN symptom|NN usually response|NN trigger|NN mark reactivity|NN persistent symptom|NN associate condition|NN
number|NN health|NN condition|NN occur frequently Asthma|Disease reflux|NN disease|NN gerd|NN obstructive sleep|NN psychological disorder|NN common anxiety|NN disorder|NN occure mood|NN disorder|NN known Asthma|Disease cause psychological problem|NN psychological problem|NN lead Asthma|Disease Asthma|Disease especially poorly control increase risk|NN radiocontrast reaction|NN cause|NN
Asthma|Disease cause combination|NN complex|NN incompletely understood environmental genetic interaction|NN influence|NN severity|NN responsiveness|NN treatment|NN believe recent increase rate|NN Asthma|Disease due chang heritable factor|NN relate dna|NN sequence|NN chang live|NN environment|NN age|NN likely due|NN genetic influence|NN onset|NN age|NN likely due|NN environmental influence|NN environmental see Asthma|Disease microbe|NN
environmental factor|NN associate Asthma|Disease development|NN exacerbation|NN allergen|NN air|NN pollution|NN environmental chemical|NN smoke|NN pregnancy|NN delivery|NN associate greater risk|NN Asthma|Disease -like symptom|NN low air|NN quality|NN factor|NN traffic|NN pollution|NN high ozone|NN level|NN associate Asthma|Disease development|NN increase Asthma|Disease severity|NN case|NN children|NN unit state|NN occur area|NN air|NN quality|NN epa|NP standard|NN low air|NN quality|NN common low-income minority|NN community|NN
exposure|NN indoor volatile organic compound|NN trigger|NN Asthma|Disease formaldehyde|NN exposure|NN example|NN positive association|NN certain type|NN pvc|NN associate Asthma|Disease children|NN adult|NN exposure|NN pesticide|NN link development|NN Asthma|Disease cause|NN effect|NN relationship|NN establish
association|NN paracetamol|NN use|NN Asthma|Disease majority|NN evidence|NN support causal role|NN 2014 review|NN found association|NN disappear respiratory infection|NN taken account|NN use|NN mother|NN pregnancy|NN associate increase risk|NN psychological stress|NN pregnancy|NN
Asthma|Disease associate exposure|NN indoor allergen|NN common indoor allergen|NN include dust|NN mite|NN cockroache|NN animal|NN fragment|NN fur|NN feather|NN mold effort|NN decrease|NN dust|NN mite|NN found ineffective symptom|NN sensitize subject|NN certain viral respiratory infection|NN respiratory syncytial|NN virus|NN increase risk|NN develop Asthma|Disease acquire young children|NN certain infection|NN decrease risk|NN hygiene|NN hypothesis|NN
hygiene|NN hypothesis|NN attempt|NN explain increase rate|NN Asthma|Disease worldwide direct unintend result|NN reduce exposure|NN childhood|NN non-pathogenic bacteria|NN viruse|NN propose reduce exposure|NN bacteria|NN viruse|NN due part|NN increase cleanliness|NN decrease family|NN size|NN modern society|NN exposure|NN bacterial endotoxin|NN early childhood|NN prevent development|NN Asthma|Disease exposure|NN older age|NN provoke evidence|NN support hygiene|NN hypothesis|NN include lower rate|NN Asthma|Disease farm|NN household|NN pet|NN
use|NN antibiotics|NN early life|NN link development|NN Asthma|Disease delivery|NN caesarean|NN section|NN associate increase risk|NN estimate 2080|NN Asthma|Disease increase risk|NN attribute lack|NN healthy bacterial colonization|NN newborn acquire passage|NN birth|NN canal|NN link|NN Asthma|Disease degree|NN affluence|NN relate hygiene|NN hypothesis|NN affluent individual|NN exposure|NN bacteria|NN viruse|NN genetic interaction|NN base cd14|NP snp|NP level|NN cc|NP genotype|NN genotype|NN high exposure|NN low risk|NN high risk|NN low exposure|NN high risk|NN low risk|NN
family|NN history|NN risk|NN factor|NN Asthma|Disease different gene|NN implicate identical twin|NN affect probability|NN disease|NN approximately end|NN gene|NN associate Asthma|Disease separate population|NN il10|NN ltc4|NN adam33 gene|NN relate immune system|NN modulate inflammation|NN
even list|NN gene|NN support highly replicate study|NN result|NN consistent population|NN test gene|NN associate Asthma|Disease genetic association|NN study|NN alone continue found
genetic variant|NN cause Asthma|Disease combine specific environmental exposure|NN example|NN specific single nucleotide|NN polymorphism|NN cd14 region|NN exposure|NN endotoxin|NN bacterial product|NN
exposure|NN come environmental source|NN tobacco|NN smoke|NN dog|NN farm|NN
risk|NN Asthma|Disease determine person|NN genetics|NN level|NN endotoxin|NN exposure|NN medical condition|NN
triad|NN eczema|NN allergic rhinitis|NN Asthma|Disease call strongest risk|NN factor|NN develop Asthma|Disease history|NN disease|NN Asthma|Disease occure greater rate|NN eczema|NN hay|NN fever|NN Asthma|Disease associate granulomatosis|NN formerly known syndrome|NN autoimmune|NN disease|NN vasculitis|NN individual|NN certain type|NN urticaria|NN experience symptom|NN Asthma|Disease
correlation|NN obesity|NN risk|NN Asthma|Disease increase recent year|NN factor|NN play|NN decrease respiratory function|NN due buildup|NN fat|NN fact|NN tissue|NN lead pro-inflammatory state|NN
beta|NN blocker|NN medication|NN propranolol|NN trigger Asthma|Disease susceptible beta-blocker appear safe mild moderate disease|NN medication|NN cause problem|NN Asthma|Disease tics|NN angiotensin-convert enzyme|NN inhibitor|NN aspirin|NN nsaids|NP use|NN acid|NN suppress medication|NN proton|NN pump|NN inhibitor|NN blocker|NN pregnancy|NN associate increase risk|NN Asthma|Disease child|NN
individual|NN stable Asthma|Disease week|NN month|NN suddenly develop episode|NN acute Asthma|Disease
different individual|NN react various factor|NN different way|NN individual|NN develop severe exacerbation|NN number|NN trigger agent|NN
home|NN factor|NN lead exacerbation|NN Asthma|Disease include dust|NN animal|NN especially cat|NN dog|NN hair|NN cockroach|NN allergen|NN mold perfume|NN common cause|NN acute attack|NN women|NN children|NN
viral bacterial infection|NN upper respiratory tract|NN worsen disease|NN psychological stress|NN worsen symptom|NN thought stress|NN alter immune system|NN increase airway|NN inflammatory response|NN allergen|NN irritant|NN main article|NN pathophysiology|NN Asthma|Disease
Asthma|Disease result|NN chronic inflammation|NN conduct|NN zone|NN airway|NN especially bronchy|NN bronchiole|NN subsequently result increase contractability|NN surround smooth muscle|NN
factor|NN lead bout|NN narrow|NN airway|NN classic symptom|NN wheez|NN
narrow|NN typically reversible treatment|NN
occasionally airway|NN change typical change|NN airway|NN include increase|NN eosinophil|NN thicken|NN lamina|NN
chronically airway|NN smooth muscle|NN increase size|NN increase|NN number|NN mucous|NN gland|NN
cell|NN type|NN involve include t|NP lymphocyte|NN macrophage|NN neutrophil|NN
involvement|NN component|NN immune system|NN cytokine|NN histamine|NN leukotriene|NN
figure|NN show location|NN lung|NN airway|NN body|NN
figure|NN show cross-section|NN normal airway|NN
figure|NN show cross-section|NN airway|NN Asthma|Disease symptom|NN
tissue|NN cross|NN section|NN airway|NN show stain pink wall|NN full white mucous|NN
obstruction|NP lumen|NN bronchiole|NN exudate goblet|NN cell|NN metaplasia|NN epithelial basement|NN membrane|NN thicken|NN person|NN Asthma|Disease
diagram|NN Asthma|Disease
Asthma|Disease well-recognize condition|NN universal|NN agree definition|NN define global initiative|NN Asthma|Disease chronic inflammatory disorder|NN airway|NN cell|NN cellular element|NN play role|NN
chronic inflammation|NN associate airway|NN lead|NN recurrent episode|NN wheez breathlessness|NN chest|NN tightness|NN cough particularly night|NN early morn|NN
episode|NN usually associate widespread variable airflow|NN obstruction|NN lung|NN reversible spontaneously treatment|NN
currently precise test|NN diagnosis|NN typically base pattern|NN symptom|NN response|NN therapy|NN time|NN diagnosis|NN Asthma|Disease suspect history|NN recurrent wheez|NN cough|NN difficulty|NN breath|NN symptom|NN occur worsen due exercise viral infection|NN allergen|NN air|NN pollution|NN spirometry|NN use confirm diagnosis|NN children|NN age|NN diagnosis|NN difficult young spirometry|NN
recommend aid|NN diagnosis|NN management|NN single best test|NN Asthma|Disease
fev1|NN measure technique|NN improve increase|NN milliliter|NN follow administration|NN bronchodilator|NN salbutamol|NN supportive diagnosis|NN
normal history|NN mild Asthma|Disease currently act caffeine|NN bronchodilator|NN people|NN Asthma|Disease use|NN caffeine|NN lung|NN function|NN test|NN interfere result|NN diffuse capacity|NN help differentiate Asthma|Disease copd|NN reasonable perform year|NN follow well person|NN Asthma|Disease control
methacholine challenge|NN involve inhalation|NN increase concentration|NN substance|NN cause airway|NN narrow|NN predispose
negative mean person|NN Asthma|Disease positive specific disease|NN
supportive evidence|NN include
difference|NN peak|NN expiratory flow|NN rate|NN day|NN week|NN week|NN
improvement|NN peak|NN flow|NN treatment|NN salbutamol|NN inhal corticosteroid|NN prednisone|NN
decrease|NN peak|NN flow|NN exposure|NN trigger|NN test|NN peak|NN expiratory flow|NN variable recommend routine|NN diagnosis|NN
useful daily self-monitor|NN moderate severe disease|NN check effectiveness|NN new medication|NN
helpful guide treatment|NN acute exacerbation classification|NN clinical classification|NN
year|NN old frequency|NN symptom|NN predict fev1|NN variability|NN use|NN intermittent
mild persistent 2week|NN
moderate persistent daily 1week|NN daily severe persistent frequent 7week|NN
Asthma|Disease clinically classify frequency|NN symptom|NN force expiratory volume|NN second|NN peak|NN expiratory flow|NN rate|NN Asthma|Disease classify extrinsic non-atopic intrinsic base symptom|NN precipitate allergen|NN Asthma|Disease classify base severity|NN moment|NN clear method|NN classify different subgroup|NN Asthma|Disease system|NN find way|NN identify subgroup|NN respond well different type|NN treatment|NN current critical goal|NN Asthma|Disease research|NN
Asthma|Disease chronic obstructive condition|NN consider part|NN chronic obstructive pulmonary disease|NN term|NN refer specifically combination|NN disease|NN irreversible emphysema|NN disease|NN airway|NN obstruction|NN Asthma|Disease usually reversible left untreate chronic inflammation|NN Asthma|Disease lead lung|NN become irreversibly obstruct due|NN airway|NN contrast|NN emphysema|NN Asthma|Disease affect bronchy|NN alveoly|NN Asthma|Disease exacerbation|NN severity|NN acute exacerbation|NN high paco2|NN require mechanical ventilation|NN clinical sign|NN measurement|NN alter level|NN consciousness|NN peak|NN flow|NN oxygen|NN saturation|NN kpa|NN low blood|NN pressure|NN normal silent chest|NN poor respiratory effort|NN acute severe peak|NN flow|NN respiratory rate|NN
breath|NN minute|NN heart|NN rate|NN
beat|NN minute|NN unable complete sentence|NN breath|NN moderate worsen|NN symptom|NN peak|NN flow|NN best predict feature|NN acute severe Asthma|Disease
acute Asthma|Disease exacerbation|NN commonly refer Asthma|Disease attack|NN
classic symptom|NN shortness|NN breath|NN wheez|NN chest|NN tightness|NN wheez|NN breath primary symptom|NN Asthma|Disease people|NN present primarily cough|NN severe case|NN air|NN motion|NN significantly impair wheez|NN heard children|NN chest|NN pain|NN present
sign|NN occure Asthma|Disease attack|NN include use|NN accessory|NN muscle|NN respiration|NN muscle|NN neck|NN paradoxical pulse|NN pulse|NN weaker inhalation|NN stronger exhalation|NN over-inflation|NN chest|NN blue color|NN skin|NN nail|NN occur lack|NN oxygen|NN
mild exacerbation|NN peak|NN expiratory flow|NN rate|NN pefr|NN
predict best moderate define lmin|NN predict best severe define
predict best
acute severe Asthma|Disease previously known status|NN Asthma|Disease ticus|NN acute exacerbation|NN Asthma|Disease respond standard treatment|NN bronchodilator|NN corticosteroid|NN case|NN due infection|NN cause air|NN pollution|NN insufficient inappropriate medication|NN use|NN
brittle Asthma|Disease kind|NN Asthma|Disease distinguishable recurrent severe attack|NN type|NN brittle Asthma|Disease disease|NN wide peak|NN flow|NN variability|NN intense medication|NN
type|NN brittle Asthma|Disease background|NN well-control Asthma|Disease sudden severe exacerbation|NN main article|NN
exercise|NN trigger people|NN Asthma|Disease occur people|NN Asthma|Disease people|NN Asthma|Disease exercise-induce bronchoconstriction|NN common professional athlete|NN
highest rate|NN cyclist|NN swimmer|NN cross-country skier|NN occur weather|NN condition|NN common dry cold inhal|NN appear improve athletic performance|NN Asthma|Disease oral dose|NN improve endurance|NN strength|NN occupational main article|NN occupational Asthma|Disease
Asthma|Disease result|NN worsen workplace|NN exposure|NN commonly report occupational disease|NN case|NN report recognize estimate Asthma|Disease case|NN adult|NN work-relate
different agent|NN implicate common grain|NN wood|NN dust|NN solder flux|NN latex|NN animal|NN aldehyde|NN
employment|NN associate highest risk|NN problem|NN include spray paint|NN baker|NN process food|NN nurse|NN chemical worker|NN work animal|NN welder|NN hairdresser|NN timber|NN worker|NN Asthma|Disease main article|NN respiratory disease|NN
respiratory disease|NN known Asthma|Disease affect Asthma|Disease tics|NN consist Asthma|Disease nasal polyp|NN sinus|NN disease|NN respiratory reaction|NN aspirin|NN nsaid medication|NN people|NN develop loss|NN smell|NN experience|NN respiratory reaction|NN alcohol|NN Asthma|Disease main article|NN respiratory reaction|NN
alcohol|NN worsen Asthma|Disease tic|NN symptom|NN people|NN even common ethnic group|NN japanese|NN Asthma|Disease study|NN found improvement|NN Asthma|Disease tic|NN symptom|NN alcohol|NN Asthma|Disease
Asthma|Disease known intrinsic nonatopic Asthma|Disease make case|NN
negative skin|NN test|NN common inhalant allergen|NN normal serum|NN concentration|NN
start later life|NN women|NN commonly affect men|NN
usual treatment|NN work well differential diagnosis|NN
condition|NN cause symptom|NN similar Asthma|Disease
children|NN upper airway|NN disease|NN allergic rhinitis|NN consider well cause|NN airway|NN obstruction|NN foreign body|NN aspiration|NN tracheal stenosis|NN vascular ring|NN enlarge lymph|NN node|NN neck|NN mass|NN viral infection|NN produce wheez|NN adult|NN congestive heart|NN failure|NN airway|NN mass|NN well drug-induce cough|NN due ace inhibitor|NN consider
population|NN vocal cord|NN dysfunction|NN present similarly
chronic obstructive pulmonary disease|NN coexist Asthma|Disease occur complication|NN chronic Asthma|Disease
age|NN people|NN obstructive airway|NN disease|NN Asthma|Disease copd
set|NN differentiate increase airway|NN neutrophil|NN abnormally increase wall|NN thickness|NN increase smooth muscle|NN bronchy|NN
level|NN investigation|NN perform due copd|NN Asthma|Disease share similar principle|NN management|NN corticosteroid|NN beta-agonist|NN smoke|NN cessation|NN closely resemble Asthma|Disease symptom|NN correlate exposure|NN cigarette|NN smoke|NN older age|NN symptom|NN administration|NN decrease likelihood|NN family|NN history|NN prevention|NN
evidence|NN effectiveness|NN measure|NN prevent development|NN Asthma|Disease weak world|NN health|NN organization|NN recommend decrease risk|NN factor|NN tobacco|NN smoke|NN air|NN pollution|NN chemical irritant|NN perfume|NN number|NN lower respiratory infection|NN effort|NN show promise|NN include limit smoke|NN exposure|NN utero|NN breastfeed|NN increase exposure|NN daycare|NN large family|NN none well support recommend indication|NN
early pet|NN exposure|NN useful result|NN exposure|NN pet|NN time|NN inconclusive recommend pet|NN remove home|NN person|NN allergic symptom|NN said pet|NN
dietary restriction|NN pregnancy|NN breast|NN feed|NN found effective recommend reduce eliminate compound|NN known sensitive people|NN work|NN place|NN effective clear annual influenza|NN vaccination|NN affect risk|NN exacerbation|NN recommend world|NN health|NN organization|NN smoke|NN ban|NN effective decrease exacerbation|NN Asthma|Disease management|NN
cure|NN Asthma|Disease symptom|NN typically improve specific customize plan|NN monitor|NN manage symptom|NN create
plan|NN include reduction|NN exposure|NN allergen|NN test assess severity|NN symptom|NN usage|NN medication|NN
treatment|NN plan|NN written advise adjustment|NN treatment|NN change|NN symptom|NN
effective treatment|NN Asthma|Disease identify trigger|NN cigarette|NN smoke|NN pet|NN aspirin|NN eliminate exposure|NN
trigger|NN avoidance|NN insufficient use|NN medication|NN recommend
pharmaceutical drug|NN select base thing|NN severity|NN illness|NN frequency|NN symptom|NN
specific medication|NN Asthma|Disease broadly classify fast-act|NN long-act|NN category|NN
recommend short-term relief|NN symptom|NN
occasional attack|NN medication|NN need
mild persistent disease|NN present attack|NN week|NN inhal corticosteroid|NN alternatively leukotriene|NN antagonist|NN mast|NN cell|NN stabilizer|NN mouth|NN recommend
daily attack|NN higher dose|NN inhal corticosteroid|NN use
moderate severe exacerbation|NN corticosteroid|NN mouth|NN ad treatment|NN
people|NN Asthma|Disease higher rate|NN anxiety|NN depression|NN associate poorer Asthma|Disease control|NN cognitive behavioral|NN therapy|NN improve quality|NN life|NN Asthma|Disease control|NN anxiety|NN level|NN people|NN Asthma|Disease lifestyle|NN modification|NN
avoidance|NN trigger|NN key component|NN improve control|NN prevent attack|NN
common trigger|NN include allergen|NN smoke|NN tobacco|NN source|NN air|NN pollution|NN selective beta-blocker|NN sulfite-contain|NN food|NN cigarette|NN smoke|NN second-hand smoke|NN passive smoke|NN reduce effectiveness|NN medication|NN corticosteroid|NN law|NN limit|NN smoke|NN decrease|NN number|NN people|NN hospitalize Asthma|Disease dust|NN mite|NN control|NN measure|NN air|NN filtration|NN chemical|NN kill mite|NN vacuume mattress|NN cover|NN method|NN effect|NN Asthma|Disease symptom|NN overal exercise|NN beneficial people|NN stable|NN Asthma|Disease yoga|NP provide small improvement|NN quality|NN life|NN symptom|NN people|NN Asthma|Disease medication|NN
use treat Asthma|Disease divide general class|NN medication|NN use treat acute symptom|NN long-term control|NN medication|NN use prevent further exacerbation|NN antibiotics|NN generally need sudden worsen|NN symptom|NN round canister|NN blue plastic|NN holder|NN meter dose|NN inhaler|NN commonly use treat Asthma|Disease attack|NN
beta2-adrenoceptor agonist|NN salbutamol|NN usan|NN line|NN treatment|NN Asthma|Disease symptom|NN recommend exercise|NN exercise|NN induce symptom|NN medication|NN bromide|NN provide additional benefit|NN use combination|NN saba|NN moderate severe symptom|NN bronchodilator|NN use person|NN tolerate saba|NN child|NN require admission|NN hospital|NN additional ipratropium|NN appear help saba|NN older selective adrenergic agonist|NN inhal epinephrine|NN similar efficacy|NN saba recommend due concern|NN excessive cardiac stimulation|NN
control|NN round canister|NN orange plastic|NN holder|NN propionate|NN meter dose|NN inhaler|NN commonly use long-term control|NN
generally consider effective treatment|NN available long-term control|NN form|NN usually use case|NN severe persistent disease|NN oral corticosteroid|NN need usually recommend inhal formulation|NN use twice daily severity|NN symptom|NN agonist|NN salmeterol|NN improve Asthma|Disease control|NN adult|NN give combination|NN inhal corticosteroid|NN children|NN benefit|NN uncertain use steroid|NN increase risk|NN severe side-effect|NN corticosteroid|NN slightly increase risk|NN evidence|NN suggest children|NN persistent Asthma|Disease treatment|NN regime|NN include ad inhal corticosteroid|NN improve lung|NN function|NN reduce amount|NN serious exacerbation|NN children|NN require part|NN Asthma|Disease treatment|NN need go hospital|NN frequently leukotriene receptor|NN antagonist|NN agent|NN use addition|NN inhal corticosteroid|NN typically conjunction|NN laba evidence|NN insufficient support use|NN acute exacerbation|NN adult|NN adolescent|NN persistent Asthma|Disease control well addition|NN anti-leukotriene agent|NN daily inhal corticosteriod|NN improve lung|NN function|NN reduce risk|NN moderate severe Asthma|Disease agent|NN effective alone adolescent|NN adult|NN clear research|NN suggest people|NN Asthma|Disease benefit receptor|NN alone year|NN age|NN agent|NN prefer add-on therapy|NN inhal corticosteroid|NN british thoracic|NN society|NN 2009|NP cochrane|NP systematic review|NN conclude agent|NN appear little benefit|NN ad inhal steroid|NN treate children|NN similar class|NN drug|NN inhibitor|NN use alternative|NN chronic treatment|NN mild|NN moderate Asthma|Disease older children|NN adult|NN 2013|NN medication|NN family|NN known intravenous administration|NN drug|NN aminophylline|NN provide improvement|NN bronchodilation|NN compare standard|NN inhal agonist|NN treatment|NN treatment|NN associate adverse effect|NN compare inhal beta-2 agonist|NN treatment|NN cell|NN stabilizer|NN sodium|NN non-prefer alternative|NN corticosteroid|NN children|NN Asthma|Disease well-control combination|NN therapy|NN inhal corticosteroid|NN ics|NP long-acting|NP beta2-agonists|NP benefit|NN harm|NN stop|NN step therapy|NN uncertain adult|NN stable Asthma|Disease take combination|NN laba|NN inhal corticosteroid|NN ics|NP stop|NN laba|NN increase risk|NN Asthma|Disease exacerbation|NN require treatment|NN corticosteroid|NN mouth|NN stop|NN probably make little important difference|NN Asthma|Disease control|NN Asthma|Disease -relate quality|NN life|NN stop increase|NN risk|NN serious adverse event|NN exacerbation|NN require emergency|NN department|NN visit|NN hospitalisation|NN uncertain
delivery|NN method|NN
typically provide metered-dose inhaler|NN combination|NN Asthma|Disease spacer|NN dry powder|NN inhaler|NN
spacer|NN plastic|NN cylinder|NN mixe medication|NN air|NN make easier receive full dose|NN drug|NN
nebulizer|NN use
spacer|NN equally effective mild moderate symptom|NN
insufficient evidence|NN available determine difference|NN exist severe disease|NN strong evidence|NN use|NN intravenous laba|NN adult|NN children|NN acute Asthma|Disease adverse effect|NN
long-term use|NN inhal corticosteroid|NN conventional dose|NN carry minor risk|NN adverse effect|NN risk|NN include thrush|NN development|NN cataract|NN slightly slow rate|NN growth|NN higher dose|NN inhal steroid|NN result lower bone|NN mineral|NN density|NN
Asthma|Disease unresponsive usual medication|NN option|NN available emergency|NN management|NN prevention|NN
additional option|NN include
oxygen|NN alleviate hypoxia|NN fall|NN corticosteroid|NN mouth|NN recommend day|NN prednisone|NN day|NN dexamethasone|NN review|NN recommend seven-day course|NN steroid|NN magnesium|NN intravenous treatment|NN increase|NN use addition|NN treatment|NN moderate severe acute Asthma|Disease attack|NN adult|NN result reduction|NN hospital|NN admission|NN mixture|NN helium|NN oxygen|NN consider severe unresponsive case|NN intravenous salbutamol|NN support available evidence|NN use extreme case|NN theophylline|NN widely use add significantly effect|NN inhal use|NN acute exacerbation|NN controversial dissociative|NN ketamine|NN theoretically useful intubation|NN mechanical ventilation|NN need people|NN approach respiratory arrest|NN evidence|NN clinical trial|NN support severe persistent Asthma|Disease control inhal corticosteroid|NN bronchial thermoplasty|NN option|NN involve delivery|NN control thermal energy|NN airway|NN wall|NN series|NN bronchoscopy|NN increase exacerbation|NN frequency|NN month|NN appear decrease subsequent rate|NN
effect|NN year|NN unknown monoclonal antibody|NN injection|NN dupilumab|NN useful poorly control allergic Asthma|Disease medication|NN expensive use|NN therefore reserve severe symptom|NN achieve cost-effectiveness|NN evidence|NN suggest immunotherapy|NN allergic rhinitis|NN Asthma|Disease improve outcome|NN unclear non-invasive positive pressure|NN ventilation|NN children|NN use|NN sufficiently study
alternative medicine|NN
people|NN Asthma|Disease chronic disorder|NN use alternative treatment|NN survey|NN show roughly use|NN form|NN unconventional therapy|NN data|NN support effectiveness|NN therapy|NN
evidence|NN insufficient support usage|NN vitamin|NN tentative support|NN use|NN exercise|NN induce bronchospasm people|NN mild moderate Asthma|Disease treatment|NN vitamin|NN d|NP supplementation|NN likely reduce risk|NN Asthma|Disease exacerbation|NN
acupuncture|NN recommend treatment|NN insufficient evidence|NN support use|NN air|NN show evidence|NN improve Asthma|Disease symptom|NN benefit|NN lung|NN function|NN apply equally positive negative ion|NN generator|NN
manual|NN therapy|NN chiropractic physiotherapeutic|NN respiratory therapeutic maneuver|NN insufficient evidence|NN support use|NN treate Asthma|Disease buteyko breath|NN technique|NN control hyperventilation|NN result reduction|NN medication|NN use|NN technique|NN effect|NN lung|NN function|NN expert|NN panel|NN felt evidence|NN insufficient support use|NN Asthma|Disease death|NN person|NN 2012|NP 2432|NN 5166 6795|NN map|NN world|NN europe|NP shade yellow|NN north|NN south|NP america|NP orange|NN southern africa|NP dark red disability-adjust|NN life|NN year|NN Asthma|Disease inhabitant|NN data|NN 250300|NN
400450 450500|NN
prognosis|NN Asthma|Disease generally good especially children|NN mild disease|NN mortality|NN decrease decade|NN due better recognition|NN improvement|NN care|NN death|NN rate|NN male|NN female|NN rate|NN vary country|NN fold|NN
cause moderate severe disability|NN people|NN low middle income|NN country|NN Asthma|Disease diagnose childhood|NN half|NN case|NN longer carry diagnosis|NN decade|NN remodel|NN observe unknown represent harmful beneficial change|NN early treatment|NN corticosteroid|NN seem prevent ameliorate decline|NN lung|NN function|NN Asthma|Disease children|NN negative effect|NN quality|NN life|NN parent|NN epidemiology|NN main article|NN epidemiology|NN Asthma|Disease map|NN world|NN europe|NP north|NP america|NP australia|NP south|NP america|NP shade red asia|NP yellow africa|NP grey rate|NN Asthma|Disease different country|NN world|NN
people|NN worldwide affect Asthma|Disease approximately 250000345000 people|NN die year|NN disease|NN rate|NN vary country|NN prevalence|NN common develop develop country|NN see lower rate|NN asia|NP eastern europe|NP africa|NP develop country|NN common economically disadvantage contrast|NN develop country|NN common affluent reason|NN difference|NN well known low middle income|NN country|NN make mortality|NN
Asthma|Disease twice common boy|NN girl|NN severe Asthma|Disease occur equal rate|NN contrast|NN adult|NN women|NN higher rate|NN Asthma|Disease men|NN common young old children|NN Asthma|Disease common reason|NN admission|NN hospital|NN emergency|NN department|NN visit|NN
global rate|NN Asthma|Disease increase significantly recognize major public health|NN problem|NN rate|NN Asthma|Disease plateau develop world|NN recent increase|NN primarily develop world|NN Asthma|Disease affect approximately population|NN united|NP states|NP people|NN united|NP kingdom|NP canada|NP australia|NP new|NP zealand|NP rate|NN
average death|NN rate|NN Asthma|Disease uk|NP higher average|NN european union|NN increase time|NN economics|NN
average cost|NN Asthma|Disease -relate hospital|NN stay|NN united|NP states|NP children|NN remain relatively stable average cost|NN Asthma|Disease -relate hospital|NN stay|NN adult|NN increase 5200|NN medicaid|NP frequent primary payer|NN children|NN adult|NN year|NN united|NP states|NP private insurance|NN second|NN frequent payer|NN children|NN adult|NN lowest income|NN community|NN united|NP states|NP higher rate|NN hospital|NN stay|NN Asthma|Disease highest income|NN community|NN history|NN detail|NN treatment|NN Asthma|Disease advertisement|NN indian cigarette|NN promote mean|NN relieve Asthma|Disease
contain belladonna|NN cannabis|NN
Asthma|Disease recognize ancient egypt|NP treate drink incense|NN mixture|NN known kyphy|NN officially name specific respiratory problem|NN hippocrates|NP circa bc greek word|NN pant|NN form basis|NN modern name|NN bc believe partly relate emotion|NN century|NN jewish physician-philosopher|NN wrote treatise|NN Asthma|Disease arabic|NN base partly arabic source|NN discuss symptom|NN propose various dietary mean|NN treatment|NN emphasize importance|NN climate|NN clean air|NN
paper|NN modern medicine|NN subject|NN try explain pathophysiology|NN disease|NN conclude Asthma|Disease cure rub chest|NN chloroform|NN medical treatment|NN include use|NN intravenous dose|NN drug|NN call pilocarpine f|NP
bosworth|NP theorize connection|NN Asthma|Disease hay|NN fever|NN refer treatment|NN Asthma|Disease oral corticosteroid|NN began use condition|NN inhal corticosteroid|NN selective short act|NN beta|NN agonist|NN came wide use|NN
notable well-document case|NN century|NN young theodore|NP roosevelt|NP
time|NN effective treatment|NN
youth|NN large part|NN shape poor health|NN partly relate Asthma|Disease
experience recure nighttime|NN Asthma|Disease attack|NN cause experience|NN smother death|NN terrify boy|NN parent|NN
Asthma|Disease known holy psychosomatic illness|NN
cause|NN consider psychological treatment|NN base psychoanalysis|NN talk|NN cure|NN psychoanalyst|NN interpret Asthma|Disease tic|NN wheeze|NN suppress cry|NN child|NN mother|NN consider treatment|NN depression|NN especially important individual|NN Asthma|Disease
