free encyclopedia|NN jump|NN navigation|NN jump|NN search|NN Constipation|Disease name|NN Constipation|Disease Constipation|Disease Constipation|Disease Constipation|Disease young child|NN seen x-ray|NN
circle|NN represent area|NN matter|NN stool|NN white surround black bowel|NN ga|NN
gastroenterology symptom|NN hard pass bowel|NN movement|NN abdominal pain|NN bloat|NN complication|NN anal fissure|NN impaction|NN cause|NN slow movement|NN stool|NN colon|NN irritable bowel|NN syndrome|NN disease|NN gluten|NN sensitivity|NN pelvic floor|NN disorder|NN risk factor|NN diabete|NN disease|NN disorder|NN colon|NN cancer|NN inflammatory bowel|NN disease|NN certain medication|NN treatment|NN drink|NN fluid|NN eate exercise|NN laxative|NN bulk|NN form agent|NN osmotic agent|NN stool|NN softener|NN lubricant|NN type|NN frequency|NN
Constipation|Disease refer bowel|NN movement|NN infrequent hard pass stool|NN hard dry symptom|NN include abdominal pain|NN bloat|NN feel|NN completely pass bowel|NN movement|NN complication|NN Constipation|Disease include anal fissure|NN impaction|NN normal frequency|NN bowel|NN movement|NN adult|NN day|NN week|NN baby|NN bowel|NN movement|NN day|NN young children|NN typically day|NN
Constipation|Disease cause|NN common cause|NN include slow movement|NN stool|NN colon|NN irritable bowel|NN syndrome|NN pelvic floor|NN disorder|NN underly associate disease|NN include hypothyroidism|NN diabete|NN disease|NN disease|NN gluten|NN sensitivity|NN colon|NN cancer|NN inflammatory bowel|NN disease|NN associate Constipation|Disease include opioid|NN certain antacid|NN calcium|NN channel|NN blocker|NN anticholinergics|NN take opioid|NN develop Constipation|Disease Constipation|Disease weight|NN loss|NN blood|NN present stool|NN history|NN inflammatory bowel|NN disease|NN colon|NN cancer|NN person|NN family|NN new onset|NN older
treatment|NN Constipation|Disease depend underly cause|NN duration|NN present measure|NN help include drink fluid|NN eate exercise|NN effective laxative|NN bulk|NN form agent|NN osmotic agent|NN stool|NN softener|NN lubricant|NN type|NN recommend laxative|NN generally reserve type|NN effective treatment|NN include biofeedback|NN rare case|NN surgery|NN
general population|NN rate|NN Constipation|Disease percent|NN elderly people|NN live|NN care|NN home|NN rate|NN Constipation|Disease 5075 percent|NN people|NN spend united|NP states|NP medication|NN Constipation|Disease year|NN content|NN
definition|NN cause|NN diet|NN medical condition|NN psychological congenital diagnostic approach|NN description|NN examination|NN diagnostic test|NN criteria|NN prevention|NN treatment|NN fiber|NN supplement|NN physical intervention|NN surgical intervention|NN epidemiology|NN history|NN special population|NN children|NN women|NN see reference|NN external link|NN
definition|NN bristol|NP stool|NN chart|NN
Constipation|Disease symptom|NN disease|NN
commonly Constipation|Disease thought|NN infrequent bowel|NN movement|NN usually stool|NN week|NN people|NN complaint|NN well
strain bowel|NN movement|NN excessive time|NN need pass bowel|NN movement|NN hard stool|NN pain|NN bowel|NN movement|NN secondary strain abdominal pain|NN abdominal bloat|NN
sensation|NN incomplete bowel|NN evacuation|NN
rome|NP criteria|NN set|NN symptom|NN help|NN standardize diagnosis|NN Constipation|Disease various age|NN group|NN
criteria|NN help physician|NN better define Constipation|Disease standardize manner|NN
cause|NN Constipation|Disease divide congenital primary|NN secondary common kind|NN primary life-threaten divide age|NN group|NN affect children|NN adult|NN
primary functional Constipation|Disease define ongo symptom|NN greater month|NN due underly cause|NN medication|NN side|NN effect|NN underly medical condition|NN associate abdominal pain|NN distinguish irritable bowel|NN syndrome|NN common kind|NN Constipation|Disease multifactorial adult|NN primary cause|NN include dietary choice|NN insufficient dietary fiber|NN fluid|NN intake|NN behavioral|NN cause|NN decrease physical activity|NN
elderly common cause|NN attribute insufficient dietary fiber|NN intake|NN inadequate fluid|NN intake|NN decrease physical activity|NN side|NN effect|NN medication|NN hypothyroidism|NN obstruction|NN colorectal cancer|NN evidence|NN support factor|NN poor
secondary cause|NN include side|NN effect|NN medication|NN opiate|NN endocrine metabolic disorder|NN hypothyroidism|NN obstruction|NN colorectal cancer|NN disease|NN gluten|NN sensitivity|NN present Constipation|Disease cystocele|NN develop result|NN chronic Constipation|Disease diet|NN
Constipation|Disease cause exacerbate low-fiber diet|NN low liquid|NN intake|NN diet dietary fiber|NN help decrease colonic transport|NN time|NN increase stool|NN bulk|NN simultaneously soften stool|NN
therefore diet|NN low fiber|NN lead primary Constipation|Disease
medication|NN Constipation|Disease side|NN effect|NN
include limit opioid|NN diuretics|NN antidepressant|NN tricyclic antidepressant|NN antagonist|NN receptor|NN antagonist|NN antacid|NN certain calcium|NN channel|NN blocker|NN nifedipine|NN cause severe Constipation|Disease due dysfunction|NN motility|NN rectosigmoid colon|NN supplement|NN calcium|NN iron|NN supplement|NN Constipation|Disease notable side|NN effect|NN
citation|NN need medical condition|NN
endocrine problem|NN lead Constipation|Disease include hypothyroidism|NN chronic kidney|NN disease|NN diabete|NN mellitus|NN cystic fibrosis|NN Constipation|Disease common individual|NN muscular myotonic dystrophy|NN
systemic disease|NN present Constipation|Disease include disease|NN systemic sclerosis|NN
Constipation|Disease number|NN structural mechanical morphological anatomical cause|NN namely create lesion|NN colon|NN stop passage|NN stool|NN colorectal cancer|NN stricture|NN anal sphincter damage|NN malformation|NN post-surgical|NN change|NN
mass|NN malignancy|NN lead Constipation|Disease external compression|NN
Constipation|Disease neurological cause|NN descend perineum|NN syndrome|NN disease|NN infant|NN disease|NN common medical disorder|NN associate Constipation|Disease
occur small minority|NN person|NN chronic Constipation|Disease obstruct defecation|NN
spinal cord|NN lesion|NN neurological disorder|NN disease|NN pelvic floor|NN dysfunction|NN lead Constipation|Disease
voluntary withhold|NN stool|NN common cause|NN Constipation|Disease choice|NN withhold due factor|NN fear|NN pain|NN fear|NN public|NN laziness|NN child|NN hold stool|NN combination|NN encouragement|NN fluid|NN laxative|NN useful overcome problem|NN early intervention|NN withhold|NN important lead anal fissure|NN congenital
number|NN disease|NN present birth|NN result Constipation|Disease children|NN
group|NN uncommon disease|NN hd|NP common congenital structural anomaly|NN lead Constipation|Disease anterior displacement|NN anus|NN anus|NN stricture|NN small left colon|NN syndrome|NN icon|NN section|NN empty
help ad
july|NP diagnostic approach|NN significant Constipation|Disease plain x-ray|NN 8-year-old|NN
diagnosis|NN typically made base person|NN description|NN symptom|NN
bowel|NN movement|NN difficult pass firm made small hard pellet|NN excret rabbit|NN qualify Constipation|Disease even occur day|NN
Constipation|Disease traditionally define bowel|NN movement|NN week|NN symptom|NN relate Constipation|Disease include bloat|NN distension|NN abdominal pain|NN headache|NN feel|NN fatigue|NN nervous exhaustion|NN sense|NN incomplete empty|NN Constipation|Disease diagnosis|NN typically view symptom|NN require evaluation|NN discern cause|NN
distinguish acute day|NN week|NN chronic month|NN year|NN onset|NN Constipation|Disease information|NN change differential diagnosis|NN
context|NN accompany symptom|NN help physician|NN discover cause|NN Constipation|Disease
people|NN describe Constipation|Disease bowel|NN movement|NN difficult pass firm stool|NN lumpy hard consistency|NN excessive strain|NN bowel|NN movement|NN
abdominal distension|NN abdominal pain|NN accompany Constipation|Disease chronic Constipation|Disease symptom|NN present day|NN month|NN month|NN associate abdominal discomfort|NN diagnose irritable bowel|NN syndrome|NN ib|NN obvious cause|NN found
poor dietary habit|NN previous abdominal surgery|NN certain medical condition|NN contribute Constipation|Disease
disease|NN associate Constipation|Disease include hypothyroidism|NN certain type|NN cancer|NN irritable bowel|NN syndrome|NN
low fiber|NN intake|NN inadequate amount|NN fluid|NN poor immobility|NN medication|NN contribute Constipation|Disease presence|NN Constipation|Disease identify base culmination|NN symptom|NN describe cause|NN Constipation|Disease figure
separate non-life-threaten serious cause|NN partly base symptom|NN
example|NN colon|NN cancer|NN suspect person|NN family|NN history|NN colon|NN cancer|NN fever|NN weight|NN loss|NN rectal bleed alarm sign|NN symptom|NN include family|NN personal history|NN inflammatory bowel|NN disease|NN age|NN onset|NN change|NN stool|NN nausea|NN vomit|NN neurological symptom|NN weakness|NN numbness|NN difficulty|NN urinate examination|NN
physical examination|NN involve abdominal exam|NN rectal exam|NN
abdominal exam|NN reveal abdominal mass|NN significant stool|NN burden|NN reveal abdominal discomfort|NN
rectal examination|NN give impression|NN anal sphincter tone|NN lower rectum|NN contain fece|NN
rectal examination|NN give information|NN consistency|NN stool|NN presence|NN blood|NN perineal irregularity|NN present skin|NN tag|NN fissure|NN anal wart|NN physical examination|NN manually physician|NN use guide diagnostic test|NN order|NN
diagnostic test|NN
functional Constipation|Disease common warrant diagnostic test|NN
image|NN laboratory|NN test|NN typically recommend alarm|NN sign|NN symptom|NN
laboratory|NN test|NN perform depend suspect underly cause|NN Constipation|Disease
test|NN include cbc|NP complete blood|NN count|NN thyroid|NN function|NN test|NN serum|NN calcium|NN serum|NN potassium|NN
abdominal x-ray|NN generally perform bowel|NN obstruction|NN suspect reveal extensive impact fecal|NN matter|NN colon|NN confirm rule cause|NN similar symptom|NN
perform abnormality|NN colon|NN tumor|NN suspect test|NN rarely order include anorectal manometry|NN anal sphincter electromyography|NN defecography|NN
colonic propagate|NN pressure|NN wave|NN sequence|NN responsible discrete movement|NN bowel|NN content|NN vital normal defecation|NN
deficiency ps|NN frequency|NN amplitude|NN extent|NN propagation|NN implicate severe defecatory dysfunction|NN
mechanism|NN normalize aberrant motor|NN pattern|NN help rectify problem|NN
recently novel therapy|NN sacral nerve|NN stimulation|NN utilize treatment|NN severe Constipation|Disease criteria|NN
rome|NP criteria|NN functional Constipation|Disease include follow present past month|NN symptom|NN start month|NN prior diagnosis|NN
strain defecation|NN bowel|NN movement|NN hard stool|NN sensation|NN incomplete evacuation|NN sensation|NN anorectal obstructionblockage|NN manual maneuver|NN facilitate defecation|NN week|NN loose stool|NN rarely present use|NN laxative|NN insufficient criteria|NN irritable bowel|NN syndrome|NN
Constipation|Disease usually easier prevent treat
follow relief|NN Constipation|Disease maintenance|NN adequate exercise|NN fluid|NN intake|NN diet|NN recommend treatment|NN
limit number|NN cause|NN require urgent medical intervention|NN result|NN severe consequence|NN
treatment|NN Constipation|Disease focus underly cause|NN known
national institute|NN health|NN care|NN excellence|NN nice break|NN Constipation|Disease adult|NN category|NN chronic Constipation|Disease unknown cause|NN Constipation|Disease due|NN opiate|NN
chronic Constipation|Disease unknown cause|NN main treatment|NN involve increase intake|NN water|NN fiber dietary supplement routine|NN use|NN laxative|NN discourage bowel|NN movement|NN come dependent use|NN
use provide form|NN mechanical stimulation|NN
large volume|NN high enema|NN give cleanse colon|NN possible low enema|NN generally useful stool|NN rectum|NN intestinal tract|NN supplement|NN
fiber supplement|NN psyllium|NN generally consider first-line treatment|NN chronic Constipation|Disease compare insoluble fiber|NN wheat|NN bran|NN
side|NN effect|NN fiber supplement|NN include bloat|NN flatulence|NN possible malabsorption|NN iron|NN calcium|NN medication|NN
patient|NN Constipation|Disease likely benefit supplement|NN
laxative|NN use milk|NN magnesia|NN polyethylene|NN glycol|NN recommend first-line agent|NN due low cost|NN safety|NN stimulant|NN use effective case|NN chronic Constipation|Disease polyethylene|NN glycol|NN appear superior lactulose|NN use improve gastrointestinal motility|NN
number|NN new agent|NN show positive outcome|NN chronic Constipation|Disease include prucalopride lubiprostone cisapride|NN widely available world|NN country|NN withdrawn west|NN
show benefit|NN Constipation|Disease potentially cause cardiac arrhythmia|NN death|NN physical intervention|NN
Constipation|Disease resist above measure|NN require physical intervention|NN manual physical removal|NN impact stool|NN use hand|NN see impaction|NN
regular exercise|NN help improve chronic Constipation|Disease surgical intervention|NN
refractory case|NN procedure|NN perform help relieve Constipation|Disease
nerve|NN stimulation|NN demonstrate effective minority|NN case|NN
colectomy anastomosis|NN intervention|NN perform patient|NN known slow colonic transit|NN time|NN defecation|NN disorder|NN treate present major operation|NN side|NN effect|NN include considerable abdominal pain|NN small bowel|NN obstruction|NN post-surgical|NN infection|NN
furthermore variable rate|NN success|NN case|NN dependent prognosis|NN
complication|NN arise Constipation|Disease include anal fissure|NN rectal prolapse|NN impaction|NN strain pass stool|NN lead hemorrhoid
later stage|NN Constipation|Disease abdomen|NN become distend hard diffusely tender
severe case|NN impaction|NN malignant Constipation|Disease exhibit symptom|NN bowel|NN obstruction|NN nausea|NN vomit tender abdomen|NN encopresis|NN soft stool|NN small intestine|NN bypass mass|NN impact fecal|NN matter|NN colon|NN
Constipation|Disease common chronic gastrointestinal disorder|NN adult|NN
definition|NN employ occur population|NN common women|NN elderly children|NN specifically Constipation|Disease known cause|NN affect female|NN affect male|NN reason|NN occur frequently elderly felt due increase number|NN health|NN problem|NN human|NN age|NN decrease physical activity|NN
population|NN worldwide report|NN Constipation|Disease chronic Constipation|Disease account|NN visit|NN annually outpatient|NN clinics|NN Constipation|Disease health|NN care|NN cost|NN total|NN annually american|NN frequent Constipation|Disease account|NN physician|NN visit year|NN spent laxative product|NN year|NN america|NP
history|NN century|NN satirical cartoon|NN monkey|NN reject old style|NN new design|NN fill marshmallow|NN opium|NN
ancient time|NN different society|NN publish medical opinion|NN health|NN care|NN provider|NN respond Constipation|Disease patient|NN various time|NN place|NN doctor|NN made claim|NN Constipation|Disease sort|NN medical social cause|NN doctor|NN history|NN treate Constipation|Disease reasonable unreasonable way|NN use|NN spatula|NN
advent|NN germ|NN theory|NN disease|NN idea|NN auto-intoxication|NN enter popular western thought|NN fresh way|NN scientific medical treatment|NN colon|NN cleanse|NN alternative medical treatment|NN became common medical practice|NN
west|NN popular thought|NN people|NN Constipation|Disease moral fail|NN gluttony|NN laziness|NN special population|NN children|NN main article|NN Constipation|Disease children|NN
approximately children|NN Constipation|Disease girl|NN boy|NN equally affect Constipation|Disease account|NN approximately general pediatrician|NN visit|NN gastroenterologist|NN visit symptom|NN carry significant financial impact|NN healthcare|NN system|NN difficult assess exact age|NN Constipation|Disease commonly arise children|NN frequently suffer Constipation|Disease conjunction|NN
example|NN include toilet|NN train|NN start|NN transfer new school|NN change|NN diet|NN especially infant|NN change|NN formula|NN transition|NN breast|NN milk|NN formula|NN cause Constipation|Disease
majority|NN Constipation|Disease case|NN ty medical disease|NN treatment|NN focuse simply relieve symptom|NN women|NN
six-week period|NN pregnancy|NN call postpartum stage|NN time|NN women|NN increase risk|NN constipate
multiple study|NN estimate prevalence|NN Constipation|Disease month|NN Constipation|Disease cause discomfort|NN women|NN recover delivery|NN process|NN especially perineal tear|NN underwent episiotomy risk|NN factor|NN increase risk|NN Constipation|Disease population|NN include
damage levator|NN muscle|NN pelvic floor|NN muscle|NN childbirth|NN delivery|NN second|NN stage|NN labor|NN deliver large child|NN
common pregnancy|NN get exacerbate constipate
cause pain|NN hemorrhoid perineal tear|NN lead Constipation|Disease patient|NN withhold bowel|NN movement|NN avoid pain|NN
pelvic floor|NN muscle|NN play important role|NN help pass|NN bowel|NN movement|NN
injury|NN muscle|NN above risk|NN factor|NN deliver large child|NN lengthy second|NN stage|NN labor|NN forcep|NN delivery|NN result Constipation|Disease enema|NN administer labor|NN alter bowel|NN movement|NN day|NN give birth|NN insufficient evidence|NN make conclusion|NN effectiveness|NN safety|NN laxative|NN group|NN people|NN see
defecation|NN rectal tenesmus|NN
