free encyclopedia|NN jump|NN navigation|NN jump|NN search|NN Encephalitis|Disease Encephalitis|Disease mry scan|NN image|NN show high signal|NN temporal lobe|NN right inferior frontal gyrus|NN Encephalitis|Disease
neurology infectious disease|NN symptom|NN headache|NN fever|NN confusion|NN stiff neck|NN vomit|NN complication|NN trouble|NN speak memory|NN problem|NN problem|NN hear|NN duration|NN week|NN month|NN recovery|NN type|NN herpes|NP simplex|NN west|NP nile|NP raby|NN eastern equine Encephalitis|Disease cause|NN infection|NN autoimmune|NN certain medication|NN unknown diagnostic method|NN base symptom|NN support blood|NN test|NN medical image|NN analysis|NN cerebrospinal fluid|NN treatment|NN medication|NN corticosteroid|NN artificial respiration|NN variable frequency|NN death|NN
Encephalitis|Disease inflammation|NN brain|NN severity|NN variable symptom|NN include headache|NN fever|NN confusion|NN stiff neck|NN vomit|NN complication|NN include seizure|NN hallucination|NN trouble|NN speak memory|NN problem|NN problem|NN hear|NN
cause|NN Encephalitis|Disease include viruse|NN herpe|NN simplex|NN virus|NN raby|NN well bacteria|NN fungy|NN parasite|NN cause|NN include autoimmune|NN disease|NN certain medication|NN case|NN cause|NN remain unknown risk|NN factor|NN include weak immune system|NN diagnosis|NN typically base symptom|NN support blood|NN test|NN medical image|NN analysis|NN cerebrospinal fluid|NN
certain type|NN preventable vaccine|NN treatment|NN include antiviral medication|NN acyclovir|NN corticosteroid|NN treatment|NN generally take place|NN hospital|NN people|NN require artificial respiration|NN immediate problem|NN control|NN rehabilitation|NN require Encephalitis|Disease estimate affect people|NN result death|NN worldwide content|NN
sign|NN symptom|NN cause|NN viral bacterial Encephalitis|Disease Encephalitis|Disease Encephalitis|Disease diagnosis|NN prevention|NN treatment|NN epidemiology|NN terminology|NN see reference|NN further read|NN external link|NN
sign|NN symptom|NN
adult|NN Encephalitis|Disease present|NN acute onset|NN fever|NN headache|NN confusion|NN sometime seizure|NN
younger|NP children|NN infant|NN present irritability|NN poor appetite|NN fever|NN neurological examination|NN usually reveal drowsy confuse person|NN
stiff neck|NN due irritation|NN meninge|NN cover brain|NN indicate patient|NN meningitis|NN Encephalitis|Disease cause|NN virus|NN viral main article|NN viral Encephalitis|Disease Encephalitis|Disease
viral Encephalitis|Disease occur direct effect|NN acute infection|NN sequelae|NN latent infection|NN
majority|NN viral case|NN Encephalitis|Disease unknown cause|NN common identifiable cause|NN viral Encephalitis|Disease herpe|NN simplex|NN infection|NN cause|NN acute viral Encephalitis|Disease raby|NN virus|NN poliovirus|NN measle|NN virus|NN
additional possible viral cause|NN arboviral st|NP
louis|NP Encephalitis|Disease west|NP nile|NP virus|NN la|NP crosse|NP strain|NN lymphocytic choriomeningitis|NN virus|NN colorado|NP tick|NN virus|NN henipavirus|NN infection|NN powassan virus|NN rare cause|NN Encephalitis|Disease bacterial
cause bacterial infection|NN bacterial meningitis|NN complication|NN current infectious disease|NN syphilis|NN secondary|NN Encephalitis|Disease
certain parasitic protozoal infestation|NN toxoplasmosis|NN malaria|NN primary amoebic|NN Encephalitis|Disease cause Encephalitis|Disease people|NN compromise immune system|NN
lyme|NP disease|NN henselae|NN cause Encephalitis|Disease
citation|NN need
bacterial pathogen|NN mycoplasma|NN cause disease|NN cause|NN inflammation|NN meninge|NN consequently Encephalitis|Disease
non-infectious cause|NN include acute disseminate Encephalitis|Disease demyelinate Encephalitis|Disease main article|NN Encephalitis|Disease
Encephalitis|Disease refer inflammatory disease|NN confine limbic system|NN brain|NN
clinical presentation|NN include disorientation|NN memory|NN loss|NN seizure|NN behavioral anomaly|NN
mry image|NN reveal structure|NN medial temporal lobe|NN case|NN limbic structure|NN
case|NN limbic Encephalitis|Disease autoimmune|NN origin|NN Encephalitis|Disease main article|NN Encephalitis|Disease
Encephalitis|Disease sign|NN include psychosis|NN abnormal movement|NN autonomic dysregulation|NN
anti-n-methyl-d-aspartate-receptor|NN Encephalitis|Disease rasmussen|NP Encephalitis|Disease example|NN autoimmune|NN Encephalitis|Disease receptor|NN Encephalitis|Disease common autoimmune|NN form|NN accompany ovarian teratoma|NN percent|NN affect women|NN year|NN age|NN Encephalitis|Disease main article|NN Encephalitis|Disease
Encephalitis|Disease identify high fever|NN headache|NN delay physical response|NN lethargy|NN
individual|NN exhibit upper body|NN weakness|NN muscular pain|NN tremor|NN cause|NN Encephalitis|Disease lethargica|NN currently known
epidemic|NN Encephalitis|Disease lethargica|NN occure worldwide diagnosis|NN spinal tap|NN newborn
people|NN diagnose Encephalitis|Disease decrease alter level|NN consciousness|NN lethargy|NN personality|NN change|NN hour|NN explainable cause|NN Encephalitis|Disease variety|NN test|NN
brain|NN scan|NN mry|NN determine inflammation|NN differentiate possible cause|NN
eeg|NN monitor|NN brain|NN activity|NN Encephalitis|Disease produce abnormal signal|NN
puncture|NN spinal tap|NN help|NN determine test|NN use cerebral-spinal fluid|NN obtain lumbar|NN region|NN
blood|NN test|NN urine|NN analysis|NN chain|NN reaction|NN pcr|NP test|NN cerebrospinal fluid|NN detect presence|NN viral dna|NN sign|NN viral Encephalitis|Disease
vaccination|NN available tick-borne|NN japanese Encephalitis|Disease consider at-risk individual|NN
encephalomyelitis complicate smallpox|NN vaccination|NN avoidable intent|NN purpose|NN smallpox|NN nearly eradicate immunization|NN observe patient|NN Encephalitis|Disease treatment|NN
treatment|NN base supportive care|NN follow
medication|NN virus|NN cause|NN antibiotics|NN bacteria|NN cause|NN use reduce brain|NN swell|NN restlessness|NN fever|NN occupational physical therapy|NN brain|NN affect
maintenance|NN therapy|NN use treat Encephalitis|Disease te|NN cause toxoplasma gondiy|NN life-threaten people|NN weak immune system|NN use|NN highly active antiretroviral|NN therapy|NN conjunction|NN establish pyrimethamine-base|NN maintenance|NN therapy|NN decrease chance|NN relapse|NN patient|NN hiv|NP approximately significant difference|NN relapse|NN impact severity|NN prognosis|NN disease|NN result|NN increase|NN healthcare|NN expenditure|NN
identification|NN poor prognostic factor|NN include cerebral edema|NN status|NN thrombocytopenia contrast|NN normal encephalogram|NN early stage|NN diagnosis|NN associate high rate|NN survival|NN epidemiology|NN Encephalitis|Disease death|NN person|NN 2012|NP 15-24|NN
number|NN new case|NN year|NN acute Encephalitis|Disease western country|NN case|NN people|NN year|NN
tropical country|NN incidence|NN people|NN year|NN number|NN case|NN Encephalitis|Disease change time|NN case|NN year|NN
approximately people|NN hospitalize Encephalitis|Disease time|NN Encephalitis|Disease estimate affect people|NN result death|NN worldwide herpes|NP simplex|NN Encephalitis|Disease incidence|NN population|NN year|NN terminology|NN
Encephalitis|Disease meningitis|NN known Encephalitis|Disease Encephalitis|Disease involvement|NN spinal cord|NN known
word|NN ancient greek enkphalo|NN brain|NN compose en head|NN medical suffix|NN inflammation|NN see
Encephalitis|Disease bickerstaff|NN Encephalitis|Disease la|NP crosse|NP Encephalitis|Disease encephalopathy|NN meningitis|NN zika virus|NN primary amoebic|NN Encephalitis|Disease pam world|NN Encephalitis|Disease day|NN
