free encyclopedia|NN jump|NN navigation|NN jump|NN search Gonorrhea|Disease
use|NN see Gonorrhea|Disease
Gonorrhea|Disease name|NN Gonorrhea|Disease Gonorrhea|Disease Gonorrhea|Disease Gonorrhea|Disease lesion|NN skin|NN phil|NP 2038|NP lesion|NN skin|NN pronunciation|NN
infectious disease|NN symptom|NN none burn urination|NN vaginal discharge|NN discharge|NN penis|NN pelvic pain|NN testicular pain|NN complication|NN inflammatory disease|NN inflammation|NN epididymis septic arthritis|NN cause|NN Gonorrhea|Disease typically sexually transmit diagnostic method|NN test urine|NN urethra|NN male|NN cervix|NN female|NN prevention|NN sex|NN person|NN uninfect sex|NN treatment|NN injection|NN azithromycin|NN mouth|NN frequency|NN women|NN men|NN
Gonorrhea|Disease colloquially known Gonorrhea|Disease sexually transmit infection|NN sty|NN cause bacterium|NN Gonorrhea|Disease infection|NN involve genital|NN mouth|NN rectum|NN men|NN experience pain|NN burn|NN urination|NN discharge|NN penis|NN testicular pain|NN women|NN experience burn urination|NN vaginal discharge|NN vaginal bleed|NN period|NN pelvic pain|NN complication|NN women|NN include pelvic inflammatory disease|NN men|NN include inflammation|NN epididymis|NN infect symptom|NN untreate Gonorrhea|Disease spread joint|NN heart|NN valve|NN
Gonorrhea|Disease spread sexual contact|NN infect person|NN include oral anal vaginal sex|NN spread mother|NN child|NN birth|NN diagnosis|NN test urine|NN urethra|NN male|NN cervix|NN female|NN test women|NN sexually active year|NN age|NN year|NN well new sexual partner|NN recommend recommendation|NN apply men|NN sex|NN men|NN msm|NP
Gonorrhea|Disease prevent use|NN condom|NN sex|NN person|NN uninfect sex|NN treatment|NN usually ceftriaxone|NN injection|NN azithromycin|NN mouth|NN resistance|NN develop previously use antibiotics|NN higher dose|NN ceftriaxone|NN occasionally require retest|NN recommend month|NN treatment|NN sexual partner|NN month|NN treate
Gonorrhea|Disease affect women|NN men|NN estimate new case|NN occur year|NN new case|NN curable sty|NN include syphilis|NN chlamydia|NN infection|NN women|NN commonly occur young adult|NN cause death|NN description|NN disease|NN date|NN back|NN common era|NN old testament|NN current name|NN use greek physician|NN galen|NN ce|NN refer unwant discharge|NN semen|NN content|NN
sign|NN symptom|NN cause|NN spread diagnosis|NN screen|NN prevention|NN treatment|NN antibiotics|NN sexual partner|NN resistance|NN epidemiology|NN history|NN research|NN reference|NN external link|NN
sign|NN symptom|NN treate gonococcal ophthalmia|NN develop infant|NN born women|NN Gonorrhea|Disease
women|NN Gonorrhea|Disease symptom|NN vaginal discharge|NN lower abdominal pain|NN pain|NN sexual intercourse|NN associate inflammation|NN uterine cervix|NN infect men|NN symptom|NN inflammation|NN penile urethra|NN associate burn sensation|NN urination|NN discharge|NN penis|NN men|NN discharge|NN burn|NN occur case|NN common symptom|NN infection|NN men|NN women|NN acquire Gonorrhea|Disease throat|NN perform oral sex|NN infect partner|NN usually male partner|NN
infection|NN produce symptom|NN case|NN produce sore throat|NN remain advance case|NN Gonorrhea|Disease cause general feel|NN tiredness|NN similar infection|NN possible individual|NN allergic reaction|NN bacteria|NN case|NN appear symptom|NN greatly intensify
incubation|NN period|NN day|NN symptom|NN appear day|NN infection|NN
rarely Gonorrhea|Disease cause skin|NN lesion|NN joint infection|NN pain|NN swell|NN joint|NN travel|NN blood|NN stream|NN see
rarely settle heart|NN cause endocarditis|NN spinal column|NN cause meningitis|NN likely individual|NN suppress immune system|NN
Gonorrhea|Disease associate increase risk|NN prostate|NN cancer|NN cause|NN multiple view|NN neisseria|NN Gonorrhea|Disease bacterium|NN cause Gonorrhea|Disease
Gonorrhea|Disease cause bacterium|NN Gonorrhea|Disease previous infection|NN confer immunity|NN person|NN infect become infect exposure|NN infect
person|NN able infect repeatedly sign|NN symptom|NN
infection|NN usually spread person|NN vaginal oral anal sex|NN men|NN risk|NN get infection|NN single act|NN vaginal intercourse|NN infect woman|NN
risk|NN men|NN sex|NN men|NN msm|NP higher active msm|NP get penile infection|NN passive msm|NP get anorectal Gonorrhea|Disease women|NN 6080 risk|NN get infection|NN single act|NN vaginal intercourse|NN infect man|NN
mother|NN transmit Gonorrhea|Disease newborn childbirth|NN affect infant|NN eye|NN refer neonatorum|NN able spread object|NN contaminate body|NN fluid|NN infect person|NN bacteria|NN typically survive long body|NN typically dy minute|NN hour|NN diagnosis|NN
traditionally Gonorrhea|Disease diagnose gram|NN stain|NN culture|NN newer polymerase|NN chain|NN reaction|NN test|NN method|NN becom common fail initial treatment|NN culture|NN determine sensitivity|NN antibiotics|NN
test|NN use polymerase|NN chain|NN reaction|NN pcr|NP aka|NN nucleic acid|NN amplification|NN identify gene|NN unique n|NP Gonorrhea|Disease recommend screen|NN diagnosis|NN Gonorrhea|Disease infection|NN
pcr-base test|NN require sample|NN urine|NN urethral swab|NN cervicalvaginal swab|NN
culture|NN grow colony|NN bacteria|NN order|NN isolate identify stain|NN bacterial cell|NN wall|NN reveal morphology|NN use detect presence|NN n|NP Gonorrhea|Disease specimen|NN type|NN urine|NN
oxidase-positive visualize direct gram|NN stain|NN urethral pus|NN male|NN genital infection|NN further test|NN need establish diagnosis|NN Gonorrhea|Disease infection|NN case|NN female infection|NN direct gram|NN stain|NN cervical swab|NN useful n|NN Gonorrhea|Disease organism|NN concentrate sample|NN
chance|NN false positive|NN increase diplococcy native|NN normal vaginal flora|NN distinguish n|NP Gonorrhea|Disease
cervical swab|NN culture condition|NN describe
oxidase|NN positive gram-negative|NN isolate culture|NN cervicalvaginal swab|NN specimen|NN diagnosis|NN made
culture|NN especially useful diagnosis|NN infection|NN throat|NN eye|NN blood|NN joint|NN area|NN pcr-base test|NN well establish lab|NN culture|NN useful antimicrobial sensitivity|NN test|NN treatment|NN failure|NN epidemiological purpose|NN outbreak|NN surveillance|NN
patient|NN disseminate Gonorrhea|Disease possible mucosal site|NN culture eg pharynx|NN cervix|NN urethra|NN rectum|NN set|NN blood|NN culture|NN obtain fluid|NN collect case|NN septic arthritis|NN
people|NN test positive Gonorrhea|Disease test sexually transmit disease|NN chlamydia|NN syphilis|NN human immunodeficiency|NN virus|NN study|NN found chlamydia|NN rang young people|NN Gonorrhea|Disease reason|NN Gonorrhea|Disease chlamydia|NN test|NN combine people|NN diagnose Gonorrhea|Disease infection|NN fivefold increase|NN risk|NN hiv|NP transmission|NN additionally infect person|NN hiv|NP positive likely shed|NN transmit hiv|NP uninfect partner|NN episode|NN Gonorrhea|Disease screen|NN
united|NP states|NP preventive service|NN task|NN force|NN recommend screen|NN Gonorrhea|Disease women|NN increase risk|NN infection|NN include sexually active women|NN younger year|NN
Gonorrhea|Disease chlamydia|NN highest men|NN sex|NN men|NN msm|NP additionally uspstf|NN recommend routine|NN screen|NN people|NN previously test positive Gonorrhea|Disease multiple sexual partner|NN individual|NN use condom|NN inconsistently provide sexual favor|NN money|NN sex|NN influence|NN alcohol|NN drug|NN
screen|NN Gonorrhea|Disease women|NN intend become pregnant found high risk|NN sexually transmit disease|NN recommend part|NN prenatal care|NN united|NP states|NP prevention|NN see safe sex|NN
sexually transmit disease|NN risk|NN infection|NN reduce significantly correct use|NN condom|NN remove entirely limit sexual activity|NN mutually monogamous relationship|NN uninfect person|NN
previously infect encourage return follow|NN care|NN make sure infection|NN eliminate
addition|NN use|NN phone|NN contact|NN use|NN email|NN text|NN message|NN found improve re-test|NN infection|NN
newborn baby|NN come birth|NN canal|NN give ointment|NN eye|NN prevent blindness|NN infection|NN
underly Gonorrhea|Disease treate usually good prognosis|NN follow treatment|NN antibiotics|NN enter mass production|NN revolutionize treatment|NN venereal disease|NN
injectable ceftriaxone|NN effective antibiotics|NN typically give combination|NN azithromycin|NN doxycycline|NN 2016 cdc|NP recommend azithromycin increase rate|NN antibiotic|NN resistance|NN local susceptibility|NN pattern|NN taken account|NN decide treatment|NN
adult|NN eye|NN infect Gonorrhea|Disease require proper personal hygiene|NN medication|NN person|NN united|NP states|NP year|NN age|NN people|NN Gonorrhea|Disease infection|NN infection|NN sexual partner|NN
recommend sexual partner|NN test potentially treate option|NN treate sexual partner|NN people|NN infect partner|NN therapy|NN involve provide prescription|NN medication|NN person|NN take partner|NN health|NN care|NN provider|NN examine
united|NP states|NP center|NN disease|NN control|NN prevention|NN cdc|NP currently recommend individual|NN diagnose treate Gonorrhea|Disease avoid sexual contact|NN week|NN final day|NN treatment|NN order|NN prevent spread|NN bacterium|NN resistance|NN
antibiotics|NN effective penicillin|NN tetracycline|NN longer recommend high rate|NN resistance|NN resistance|NN cefixime|NP reach level|NN longer recommend first-line agent|NN united|NP states|NP use person|NN test week|NN determine infection|NN persist case|NN resistance|NN ceftriaxone|NP report rare public health|NN official|NN concern emerge pattern|NN resistance|NN predict global epidemic|NN uk health|NN protection|NN agency|NN report saw slight drop|NN Gonorrhea|Disease antibiotic|NN resistance|NN year|NN life|NN year|NN Gonorrhea|Disease inhabitant|NN
data|NN 2639|NN 6578|NN
91104 104117|NN
Gonorrhea|Disease left untreate last week|NN month|NN higher risk|NN complication|NN complication|NN Gonorrhea|Disease systemic dissemination|NN result skin|NN septic arthritis|NN meningitis|NN occur infect women|NN infect men|NN
men|NN inflammation|NN epididymis prostate|NN gland|NN urethra|NN result untreate Gonorrhea|Disease women|NN common result|NN untreate Gonorrhea|Disease pelvic inflammatory disease|NN
complication|NN include inflammation|NN tissue|NN surround liver|NN rare complication|NN associate syndrome|NN septic arthritis|NN finger|NN wrist|NN toe|NN ankle|NN septic abortion|NN pregnancy|NN neonatal adult blindness|NN conjunctivitis|NN infertility|NN
men|NN Gonorrhea|Disease infection|NN increase risk|NN get prostate|NN cancer|NN epidemiology|NN Gonorrhea|Disease rate|NN united|NP states|NP
case|NN Gonorrhea|Disease occur year|NN new case|NN curable sty|NN year|NN include syphilis|NN chlamydia|NN trichomoniasis|NN 2013|NN cause death|NN
united|NP kingdom|NP male|NN year|NN old female|NN year|NN old diagnose cdc|NP estimate people|NN unit state|NN get new Gonorrhea|Disease infection|NN year|NN
infection|NN report cdc|NP
321849|NN case|NN Gonorrhea|Disease report cdc|NP
implementation|NN national Gonorrhea|Disease control|NN program|NN mid-1970|NN national Gonorrhea|Disease rate|NN decline
small increase|NN Gonorrhea|Disease rate|NN decrease slightly
rate|NN report Gonorrhea|Disease infection|NN person|NN
second-most-common bacterial sexually transmit infection|NN chlamydia|NN remain cdc|NP african american|NN affect Gonorrhea|Disease account|NN Gonorrhea|Disease case|NN
world|NN health|NN organization|NN warn 2017|NN spread|NN untreatable strain|NN Gonorrhea|Disease follow analysis|NN case|NN japan|NP france|NP spain|NP survive antibiotic|NN treatment|NN history|NN world|NN war|NN government|NN use poster|NN warn military personnel|NN danger|NN Gonorrhea|Disease sexually transmit infection|NN
scholar|NN translate biblical term|NN male|NN zavah|NN female|NN Gonorrhea|Disease
suggest mercury|NN use treatment|NN Gonorrhea|Disease
surgeon|NN tool|NN board|NN recover english warship|NN mary|NP rose|NP include syringe|NN use inject mercury|NN urinary meatus|NN unfortunate crewman|NN suffer|NN Gonorrhea|Disease
name|NN Gonorrhea|Disease reference|NN disease|NN record early century|NN refer medieval red-light district|NN paris|NP les|NP Gonorrhea|Disease iers|NP
translate rabbit|NN hole|NN name small hut|NN prostitute|NN work
wilhelm|NP gollmann|NP address Gonorrhea|Disease book|NN guide|NN disease|NN urinary sexual organ|NN
note disease|NN common prostitute|NN homosexual|NN large city|NN
recommend follow|NN cure|NN aconite|NN cure|NN shoot|NN pain|NN soreness|NN inflammation|NN mercury|NN stitch|NN pain|NN discharge|NN vomica|NN sulphur|NN symptom|NN complicate hemorrhoid|NN stricture|NN rectum|NN
remedy|NN include aurum gold|NN belladonna|NN phosphorus|NN sepia|NN
silver|NP nitrate|NN widely use drug|NN century|NN
became replace
arthur|NP eichengrün|NP invent type|NN colloidal silver|NN market bayer|NP onward
silver-base treatment|NN use antibiotics|NN came use|NN
exact time|NN onset|NN Gonorrhea|Disease prevalent disease|NN epidemic|NN accurately determine historical record|NN
reliable notation|NN occur act|NN english parliament|NN
body|NN pass law|NN reduce spread|NN perilous infirmity|NN burn symptom|NN describe consistent diagnostic Gonorrhea|Disease
similar decree|NN pass louis|NP france|NP replace regulation|NN banishment|NN similar symptom|NN note siege|NN acre|NN crusader|NN
coincidental dependent appearance|NN Gonorrhea|Disease epidemic|NN change|NN occure european medieval society|NN
city|NN hire public health|NN doctor|NN treat afflict patient|NN right|NN refusal|NN
pope|NP boniface|NP rescind requirement|NN physician|NN complete study|NN lower order|NN catholic priesthood|NN
medieval public health|NN physician|NN employ|NN city|NN require treat prostitute|NN infect burn|NN well leper|NN epidemic|NN victim|NN pope|NP boniface|NP completely practice|NN medicine|NN physician|NN treat sexually transmit disease|NN research|NN
vaccine|NN Gonorrhea|Disease develop effective mice|NN available human use|NN further study|NN demonstrate safe effective human population|NN
development|NN vaccine|NN complicate ongo evolution|NN resistant strain|NN antigenic variation|NN ability|NN n|NP Gonorrhea|Disease disguise different surface|NN marker|NN evade immune system|NN
n|NP Gonorrhea|Disease closely relate n|NP homology|NN genetic sequence|NN cross-protection|NN meningococcal vaccine|NN plausible
study|NN publish 2017|NP show group|NN vaccine|NN partial protection|NN Gonorrhea|Disease vaccine|NN efficiency|NN calculate
