free encyclopedia|NN jump|NN navigation|NN jump|NN search|NN Guillain–Barré syndrome|Disease name|NN Guillain–Barré syndrome|Disease Guillain–Barré syndrome|Disease Guillain–Barré syndrome|Disease spirodoc|NN handheld spirometry|NN device|NN use anticipate breath|NN complication|NN Guillain–Barré syndrome|Disease pronunciation|NN
neurology symptom|NN muscle|NN weakness|NN begine|NN feet|NN hand|NN complication|NN breath difficulty|NN heart|NN blood|NN pressure|NN problem|NN usual onset|NN rapid hour|NN week|NN cause|NN unknown diagnostic method|NN base symptom|NN nerve|NN conduction|NN study|NN lumbar|NN puncture|NN treatment|NN care|NN intravenous immunoglobulin|NN week|NN year|NN recovery|NN frequency|NN people|NN year|NN death|NN affect
Guillain–Barré syndrome|Disease Guillain–Barré syndrome|Disease rapid-onset muscle|NN weakness|NN cause immune system|NN damage peripheral nervous system|NN initial symptom|NN typically change|NN sensation|NN pain|NN muscle|NN weakness|NN begine|NN feet|NN hand|NN spread arm|NN upper body|NN side|NN involve symptom|NN develop hour|NN week|NN acute phase|NN disorder|NN life-threaten develop weakness|NN breath|NN muscle|NN require mechanical ventilation|NN affect change|NN function|NN autonomic nervous system|NN lead dangerous abnormality|NN heart|NN rate|NN blood|NN pressure|NN
cause|NN unknown underly mechanism|NN involve autoimmune|NN disorder|NN body immune system|NN mistakenly attack peripheral nerve|NN damage|NN myelin|NN insulation|NN sometime immune dysfunction|NN trigger infection|NN commonly surgery|NN rarely vaccination|NN diagnosis|NN usually made base sign|NN symptom|NN exclusion|NN alternative cause|NN support test|NN nerve|NN conduction|NN study|NN examination|NN cerebrospinal fluid|NN number|NN subtype|NN base area|NN weakness|NN result|NN nerve|NN conduction|NN study|NN presence|NN certain antibody|NN classify acute polyneuropathy|NN
severe weakness|NN prompt|NN treatment|NN intravenous immunoglobulin|NN plasmapheresis|NN together supportive care|NN lead good recovery|NN majority|NN people|NN recovery|NN take week|NN year|NN permanent weakness|NN death|NN occur affect Guillain–Barré syndrome|Disease rare case|NN people|NN year|NN sexe|NN part|NN world|NN similar rate|NN disease|NN syndrome|NN name french|NN georges|NP jean|NP alexandre|NP barr|NP describe french physician|NN strohl|NN content|NN
sign|NN symptom|NN respiratory failure|NN dysfunction|NN cause|NN mechanism|NN diagnosis|NN spinal fluid|NN clinical subtype|NN treatment|NN respiratory failure|NN pain|NN rehabilitation|NN epidemiology|NN history|NN research|NN direction|NN reference|NN further read|NN external link|NN
sign|NN symptom|NN
symptom|NN Guillain–Barré syndrome|Disease numbness|NN tingle|NN pain|NN alone combination|NN
follow weakness|NN leg|NN arm|NN affect side|NN equally worsen time|NN weakness|NN take day|NN week|NN reach maximum severity|NN become steady people|NN weakness|NN continue progress|NN long week|NN muscle|NN neck|NN affect experience|NN involvement|NN cranial nerve|NN supply head|NN face|NN lead weakness|NN muscle|NN face|NN swallow difficulty|NN sometime weakness|NN eye|NN muscle|NN weakness|NN affect leg|NN involvement|NN muscle|NN control bladder|NN anus|NN unusual total|NN people|NN Guillain–Barré syndrome|Disease continue able walk weakness|NN stop progress persist stable level|NN plateau|NN phase|NN improvement|NN occur
plateau|NN phase|NN take day|NN month|NN common duration|NN week|NN symptom|NN affect half|NN include back pain|NN painful tingle muscle|NN pain|NN pain|NN head|NN neck|NN relate irritation|NN line|NN brain|NN
people|NN Guillain–Barré syndrome|Disease experience sign|NN symptom|NN infection|NN week|NN prior onset|NN neurological symptom|NN
consist upper respiratory tract|NN infection|NN rhinitis|NN sore throat|NN diarrhea|NN
children|NN particularly younger year|NN old diagnosis|NN difficult condition|NN initially mistaken sometime week|NN cause|NN pain|NN difficulty|NN walk|NN viral infection|NN bone|NN joint problem|NN
neurological examination|NN characteristic|NN feature|NN reduce strength|NN muscle|NN reduce absent tendon|NN reflexe|NN areflexia respectively
small proportion|NN normal reflexe|NN affect limb|NN develop areflexia|NN exaggerate reflexe|NN miller|NP fisher|NP variant|NN Guillain–Barré syndrome|Disease see triad|NN weakness|NN eye|NN muscle|NN abnormality|NN coordination|NN well absent reflexe|NN found level|NN consciousness|NN normally unaffect Guillain–Barré syndrome|Disease bickerstaff brainstem|NN encephalitis|NN subtype|NN feature drowsiness|NN sleepiness|NN coma|NN respiratory failure|NN
quarter|NN people|NN Guillain–Barré syndrome|Disease develop weakness|NN breath|NN muscle|NN lead respiratory failure|NN inability|NN breathe adequately maintain healthy level|NN oxygen|NN carbon|NN dioxide|NN blood|NN life-threaten scenario|NN complicate medical problem|NN pneumonia|NN severe infection|NN blood|NN clot|NN lung|NN bleed digestive tract|NN require artificial ventilation|NN dysfunction|NN
autonomic involuntary nervous system|NN involve control|NN body|NN function|NN heart|NN rate|NN blood|NN pressure|NN affect people|NN Guillain–Barré syndrome|Disease impact|NN variable|NN percent|NN experience severe blood-pressure|NN fluctuation|NN irregularity|NN heart|NN beat sometime point|NN heart|NN beat|NN stop|NN require treatment|NN associate problem|NN abnormality|NN perspiration|NN change|NN reactivity|NN pupil|NN nervous system|NN involvement|NN affect even severe muscle|NN weakness|NN cause scan|NN electron|NN image|NN campylobacter|NN trigger case|NN Guillain–Barré syndrome|Disease
people|NN Guillain–Barré syndrome|Disease experience infection|NN onset|NN condition|NN
commonly episode|NN gastroenteritis|NN respiratory tract|NN infection|NN
case|NN exact nature|NN infection|NN confirm approximately case|NN provoke campylobacter|NN bacteria|NN cause
further attributable cytomegalovirus|NN
people|NN campylobacter|NN infection|NN develop Guillain–Barré syndrome|Disease 025065|NN episode|NN respectively strain|NN campylobacter|NN involve determine risk|NN Guillain–Barré syndrome|Disease different form|NN bacteria|NN different lipopolysaccharide|NN surface|NN induce illness|NN see
link|NN infection|NN Guillain–Barré syndrome|Disease certain
herpesviruse|NN virushhv-4|NN zoster|NN bacterium|NN pneumoniae|NN associate Guillain–Barré syndrome|Disease tropical viral infection|NN fever|NN virus|NN associate episode|NN Guillain–Barré syndrome|Disease previous hepatitis|NN e|NN virus|NN infection|NN found common people|NN Guillain–Barré syndrome|Disease
case|NN trigger influenza|NN virus|NN potentially influenza|NN vaccine|NN
increase incidence|NN Guillain–Barré syndrome|Disease follow influenza|NN immunization|NN follow swine|NN flu|NN outbreak|NN case|NN recipient|NN develop complication|NN
close monitor|NN case|NN attributable vaccination|NN demonstrate influenza|NN induce Guillain–Barré syndrome|Disease
small increase|NN incidence|NN observe subsequent vaccination|NN campaign|NN extent|NN 2009 flu|NN pandemic vaccine|NN pandemic swine|NN flu|NN virus|NN cause significant increase|NN case|NN consider benefit|NN vaccination|NN prevent influenza|NN outweigh small risk|NN Guillain–Barré syndrome|Disease vaccination|NN even previously experience Guillain–Barré syndrome|Disease consider safe receive vaccine|NN future vaccine|NN poliomyelitis|NN tetanus|NN measle|NN associate risk|NN Guillain–Barré syndrome|Disease mechanism|NN structure|NN typical neuron|NN neuron|NN end|NN elongate structure|NN branch mass|NN
centre|NN mass|NN nucleus|NN branche|NN dendrite|NN
thick axon|NN trail|NN mass end|NN further branch label axon|NN terminal|NN
axon|NN number|NN protuberance|NN label myelin|NN sheath|NN
soma|NN node|NN axon terminal|NN schwann|NP cell|NN sheath|NN Guillain–Barré syndrome|Disease nerve|NN damage|NN
nerve|NN dysfunction|NN Guillain–Barré syndrome|Disease cause immune attack|NN nerve|NN cell|NN peripheral nervous system|NN support|NN structure|NN
nerve|NN cell|NN body|NN soma|NN spinal cord|NN long projection|NN axon|NN carry electrical nerve|NN impulse|NN neuromuscular junction|NN impulse|NN transfer muscle|NN
wrap sheath|NN schwann|NP cell|NN contain myelin|NN
schwann|NP cell|NN gap|NN node|NN ranvier|NN axon|NN expose different type|NN Guillain–Barré syndrome|Disease feature|NN different type|NN immune attack|NN
demyelinate variant|NN see feature|NN damage|NN myelin|NN sheath|NN white blood|NN cell|NN t|NP lymphocyte|NN macrophage|NN process|NN precede activation|NN group|NN blood|NN protein|NN known complement|NN
contrast|NN axonal variant|NN mediate igg|NN antibody|NN complement|NN cell|NN membrane|NN cover axon|NN direct lymphocyte|NN involvement|NN
various antibody|NN direct nerve|NN cell|NN report Guillain–Barré syndrome|Disease
axonal subtype|NN antibody|NN show bind ganglioside|NN group|NN substance|NN found peripheral nerve|NN
ganglioside|NN molecule|NN consist ceramide|NN bound small group|NN hexose-type sugar|NN contain various number|NN acid|NN group|NN
key ganglioside|NN antibody|NN describe gm1 gd1a gq1b different anti-ganglioside antibody|NN associate particular feature|NN instance|NN antibody|NN link miller|NP fisher|NP variant|NN Guillain–Barré syndrome|Disease relate form|NN encephalitis|NN production|NN antibody|NN infection|NN probably result|NN molecular mimicry|NN immune system|NN react microbial substance|NN resultant antibody|NN react substance|NN occure naturally body|NN campylobacter|NN infection|NN body|NN produce antibody|NN iga|NN class|NN small proportion|NN people|NN produce igg|NN antibody|NN bacterial substance|NN cell|NN wall|NN substance|NN eg crossreact|NN human nerve|NN cell|NN ganglioside|NN
currently known process|NN escape central tolerance|NN ganglioside|NN meant suppress production|NN antibody|NN body|NN substance|NN antiganglioside antibody|NN cause|NN disease|NN recently suggest antibody|NN bind type|NN epitope|NN simultaneously heterodimeric bind determine response|NN
furthermore development|NN pathogenic antibody|NN depend presence|NN strain|NN bacteria|NN bowel|NN diagnosis|NN
diagnosis|NN Guillain–Barré syndrome|Disease depend find|NN rapid development|NN muscle|NN paralysis|NN absent reflexe|NN absence|NN fever|NN likely cause|NN
fluid|NN analysis|NN lumbar|NN spinal puncture|NN nerve|NN conduction|NN study|NN supportive investigation|NN commonly perform diagnosis|NN Guillain–Barré syndrome|Disease test|NN antiganglioside antibody|NN perform contribution|NN diagnosis|NN usually limit blood|NN test|NN generally perform exclude possibility|NN cause|NN weakness|NN low level|NN potassium|NN blood|NN abnormally low level|NN sodium|NN blood|NN encounter Guillain–Barré syndrome|Disease
attribute inappropriate secretion|NN hormone|NN lead relative retention|NN water|NN
case|NN magnetic resonance|NN image|NN spinal cord|NN perform distinguish Guillain–Barré syndrome|Disease condition|NN cause limb|NN weakness|NN spinal cord|NN compression|NN mry scan|NN show enhancement|NN nerve|NN root|NN indicative Guillain–Barré syndrome|Disease children|NN feature|NN present scan|NN specific Guillain–Barré syndrome|Disease confirmation|NN need spinal fluid|NN
fluid|NN envelop brain|NN spine|NN lumbar|NN puncture|NN spinal tap|NN removal|NN small amount|NN fluid|NN use needle|NN insert lumbar|NN vertebrae|NN
characteristic find|NN Guillain–Barré syndrome|Disease elevate protein|NN level|NN usually greater gl|NN white blood|NN cell|NN cubic millimeter|NN fluid|NN dissociation|NN pattern|NN distinguishe Guillain–Barré syndrome|Disease condition|NN lymphoma|NN poliomyelitis|NN protein|NN cell|NN count|NN elevate
elevated|NP csf|NP protein|NN level|NN found approximately patient|NN day|NN onset|NN weakness|NN increase week|NN
repeate lumbar|NN puncture|NN disease|NN course|NN recommend
protein|NN level|NN rise treatment|NN administer
directly assess nerve|NN conduction|NN electrical impulse|NN exclude cause|NN acute muscle|NN weakness|NN well distinguish different type|NN Guillain–Barré syndrome|Disease
needle|NN emg|NP nerve|NN conduction|NN study|NN perform
week|NN investigation|NN show abnormality|NN study|NN require diagnosis|NN
formal criteria|NN exist main subtype|NN Guillain–Barré syndrome|Disease see misclassify case|NN particularly reversible conduction|NN failure|NN therefore change|NN criteria|NN propose sometime repeate test|NN helpful clinical subtype|NN
number|NN subtype|NN Guillain–Barré syndrome|Disease recognize people|NN overlap symptom|NN make classification|NN difficult individual case|NN type|NN partial form|NN
instance|NN people|NN experience isolate coordination|NN problem|NN thought subtype|NN miller|NP fisher|NP syndrome|NN similar antiganglioside antibody|NN pattern|NN type|NN symptom|NN population|NN affect nerve|NN conduction|NN study|NN antibody|NN acute inflammatory demyelinate|NN sensory symptom|NN muscle|NN weakness|NN cranial nerve|NN weakness|NN autonomic involvement|NN common europe|NP north|NP america|NP demyelinating|NP clear association|NN acute motor|NN neuropathy|NN isolate muscle|NN weakness|NN sensory symptom|NN cranial nerve|NN involvement|NN uncommon rare europe|NP north|NP america|NP substantial proportion|NN asia|NP central south|NP america|NP sometime call chinese paralytic syndrome|NN normal sensory action|NN potential|NN acute motor|NN sensory axonal|NN neuropathy|NN severe muscle|NN weakness|NN similar aman|NN sensory loss|NN reduce absent sensory action|NN potential|NN pharyngeal-cervical-brachial variant|NN weakness|NN particularly throat|NN muscle|NN face|NN neck|NN shoulder|NN muscle|NN generally normal sometime neuropathy|NN arm|NN mostly occasionally rarely miller|NP fisher|NP syndrome|NN eye|NN muscle|NN weakness|NN usually limb|NN weakness|NN variant|NN occur commonly men|NN women|NN ratio|NN
case|NN typically occur spring|NN average age|NN occurrence|NN year|NN old generally normal sometime discrete change|NN sensory conduction|NN h-reflex|NN detect
diagnostic entity|NN include spectrum|NN Guillain–Barré syndrome|Disease
brainstem|NN encephalitis|NN instance|NN part|NN group|NN condition|NN regard form|NN miller|NP fisher|NP syndrome|NN antibody|NN syndrome|NN well relate condition|NN label acute ataxic|NN coordination|NN problem|NN drowsiness|NN present muscle|NN weakness|NN detect characterize rapid onset|NN ophthalmoplegia|NN disturbance|NN consciousness|NN associate absent decrease tendon|NN reflexe|NN well sign|NN course|NN disease|NN usually monophasic recurrent episode|NN report
mry abnormality|NN brainstem|NN report
isolate acute sensory loss|NN regard form|NN Guillain–Barré syndrome|Disease matter|NN dispute|NN rare occurrence|NN compare Guillain–Barré syndrome|Disease muscle|NN weakness|NN sensory symptom|NN treatment|NN
intravenous immunoglobulin|NN main immunotherapy treatment|NN Guillain–Barré syndrome|Disease
attempt|NN reduce body attack|NN nervous system|NN filter|NN antibody|NN bloodstream|NN
similarly administration|NN neutralize harmful antibody|NN inflammation|NN
treatment|NN equally effective combination|NN significantly better alone plasmapheresis|NN speed|NN recovery|NN use week|NN onset|NN symptom|NN work well plasmapheresis|NN start week|NN onset|NN symptom|NN complication|NN usually use ease|NN administration|NN safety|NN
use|NN risk|NN occasionally cause liver|NN inflammation|NN rare case|NN kidney|NN failure|NN alone found effective speed recovery|NN potentially delay recovery|NN respiratory failure|NN
respiratory failure|NN require intubation|NN trachea|NN breath|NN support|NN mechanical ventilation|NN generally intensive care|NN unit|NN
need|NN support|NN anticipate measurement|NN spirometry-base breath|NN test|NN force vital capacity|NN negative inspiratory|NN force|NN
fvc|NN ml|NN kilogram|NN body|NN weight|NN nif|NN cmh2o|NN consider marker|NN severe respiratory failure|NN pain|NN
pain|NN common people|NN Guillain–Barré syndrome|Disease study|NN compare different type|NN pain|NN medication|NN insufficient make recommendation|NN use rehabilitation|NN
follow acute phase|NN people|NN require intensive rehabilitation|NN help|NN multidisciplinary team|NN focus|NN improve activity|NN daily live|NN study|NN subject|NN limit likely intensive rehabilitation|NN improve long-term symptom|NN team|NN include physical therapist|NN occupational therapist|NN speech|NN language|NN pathologist|NN social worker|NN psychologist|NN ally health|NN professional|NN nurse|NN
team|NN usually work supervision|NN neurologist|NN rehabilitation|NN physician|NN direct treatment|NN goal|NN
physiotherapy|NN intervention|NN include strength|NN endurance|NN gait|NN train|NN graduate increase|NN mobility|NN maintenance|NN posture|NN alignment|NN well joint function|NN
occupational therapy|NN aim improve everyday function|NN domestic community|NN task|NN well drive|NN work|NN
home|NN modification|NN gait|NN aid|NN splint|NN provide pathology|NN input|NN require speech|NN swallow problem|NN well support|NN communication|NN require ongo breath|NN support|NN tracheostomy|NN
nutritional support|NN provide team|NN
psychologist|NN provide support|NN
psychological intervention|NN require anxiety|NN fear|NN depression|NN
Guillain–Barré syndrome|Disease lead death|NN result|NN number|NN complication|NN severe infection|NN blood|NN clot|NN cardiac arrest|NN likely due|NN autonomic neuropathy|NN
optimum care|NN occur case|NN
variation|NN rate|NN extent|NN recovery|NN prognosis|NN Guillain–Barré syndrome|Disease determine mainly age|NN poorer outcome|NN severity|NN symptom|NN week|NN
furthermore experience onset|NN disease|NN worse prognosis|NN nerve|NN conduction|NN study|NN presence|NN conduction|NN block|NN predict poorer outcome|NN month|NN receive intravenous immunoglobulin|NN smaller increase|NN igg|NN blood|NN week|NN administration|NN associate poorer mobility|NN outcome|NN month|NN igg|NN level|NN increase substantially disease|NN continue progress|NN week|NN multiple fluctuation|NN severity|NN week|NN diagnosis|NN chronic inflammatory demyelinate|NN treate differently
research|NN study|NN outcome|NN episode|NN Guillain–Barré syndrome|Disease record scale|NN denote completely healthy minor symptom|NN able run able walk|NN run|NN require stick|NN support|NN confine bed|NN chair|NN require long-term respiratory support|NN death|NN
health-relate quality|NN life|NN attack|NN Guillain–Barré syndrome|Disease significantly impair
unable walk unaid month|NN experience|NN chronic pain|NN fatigue|NN difficulty|NN work|NN education|NN hobby|NN social activity|NN improve significantly year|NN epidemiology|NN see list|NN people|NN Guillain–Barré syndrome|Disease
western country|NN number|NN new episode|NN year|NN estimate 089|NN case|NN people|NN
children|NN young adult|NN likely affect elderly risk|NN increase|NN decade|NN life|NN men|NN likely develop Guillain–Barré syndrome|Disease women|NN relative risk|NN men|NN compare women|NN
distribution|NN subtype|NN vary country|NN
europe|NP united|NP states|NP people|NN Guillain–Barré syndrome|Disease demyelinate subtype|NN affect small number|NN
asia|NP central south|NP america|NP proportion|NN significantly higher 3065|NN
relate exposure|NN different kind|NN infection|NN genetic characteristics|NN population|NN miller|NP fisher|NP variant|NN thought common southeast|NN asia|NP history|NN georges|NP together barr|NP strohl|NP describe case|NN acute paralysis|NN peculiar change|NN cerebrospinal fluid|NN
succeed teacher|NN pierre|NP marie|NP professor|NN neurology|NN salptrire hospital|NN paris|NP
french physician|NN jean-baptiste|NP octave|NP landry|NP describe disorder|NN georges|NP jean|NP alexandre|NP barr|NP andr|NP strohl|NP diagnose soldier|NN illness|NN describe key diagnostic abnormalityalbuminocytological|NN increase spinal fluid|NN protein|NN concentration|NN normal cell|NN count|NN
canadian neurologist|NN c|NP
miller|NP fisher|NP describe variant|NN bear name|NN british neurologist|NN edwin|NP base birmingham|NP describe brainstem|NN encephalitis|NN type|NN philip|NP made further contribution|NN paper|NN guillain|NN report feature|NN prior full description|NN further subtype|NN describe form|NN feature pure ataxia|NN type|NN cause weakness|NN axonal subtype|NN describe
diagnostic criteria|NN develop late series|NN case|NN associate swine|NN flu|NN vaccination|NN
refine case|NN definition|NN revise brighton|NP collaboration|NN vaccine|NN safety|NN 2009|NN mainly intend research|NN plasma|NN exchange|NN use benefit|NN confirm larger study|NN intravenous immunoglobulin|NN introduce non-inferiority|NN compare plasma|NN exchange|NN demonstrate study|NN early research|NN direction|NN
understand|NN disease|NN mechanism|NN Guillain–Barré syndrome|Disease evolve recent year|NN development|NN new treatment|NN limit immunotherapy|NP introduce current research|NN aim demonstrate people|NN receive benefit course|NN antibody|NN level|NN measure blood|NN treatment|NN show small increase|NN study|NN immunosuppressive drug|NN brain-derive|NN factor|NN interferon|NN beta|NN
demonstrate benefit|NN support widespread use|NN
animal|NN model|NN experimental autoimmune|NN rat|NN use study|NN agent|NN show promise|NN acetate|NN inhibitor|NN rho-kinase enzyme|NN heart|NN drug|NN antibody|NN target anti-gd3|NN antibody|NN show benefit|NN laboratory|NN research|NN role|NN complement|NN system|NN Guillain–Barré syndrome|Disease suggest complement|NN inhibitor|NN drug|NN eculizumab|NN effective
