free encyclopedia|NN jump|NN navigation|NN jump|NN search|NN Huntington's disease|Disease name|NN Huntington's disease|Disease Huntington's disease|Disease neuron|NN yellow large central core|NN tendril|NN branch core|NN neuron|NN foreground|NN contain orange blob|NN quarter|NN diameter|NN edit microscopic image|NN medium spiny neuron|NN yellow nuclear inclusion|NN orange|NN occur part|NN disease|NN process|NN image|NN width|NN symptom|NN problem|NN mood|NN mental ability|NN coordination|NN jerky body|NN movement|NN complication|NN pneumonia|NN heart|NN disease|NN physical injury|NN fall|NN suicide|NN usual onset|NN year|NN old duration|NN long term|NN cause|NN genetic inherit new mutation|NN diagnostic method|NN genetic test|NN differential diagnosis|NN benign hereditary chorea|NN syndrome|NN wilsons|NP disease|NN treatment|NN care|NN tetrabenazine|NN year|NN diagnosis|NN frequency|NN european descent|NN
Huntington's disease|Disease Huntington's disease|Disease known Huntington's disease|Disease inherit disorder|NN result|NN death|NN brain|NN cell|NN earliest symptom|NN subtle problem|NN mood|NN mental ability|NN general lack|NN coordination|NN unsteady gait|NN follow disease|NN advance|NN uncoordinate jerky body|NN movement|NN become apparent physical ability|NN gradually worsen coordinate movement|NN become difficult person|NN unable talk mental ability|NN generally decline|NN dementia|NN specific symptom|NN vary somewhat people|NN symptom|NN usually begin year|NN age|NN start age|NN disease|NN develop earlier life|NN successive generation|NN percent|NN case|NN start|NN age|NN year|NN typically present symptom|NN similar disease|NN people|NN Huntington's disease|Disease underestimate degree|NN problem|NN
Huntington's disease|Disease typically inherit case|NN due new mutation|NN disease|NN cause autosomal dominant mutation|NN individual|NN copy|NN gene|NN call mean child|NN affect person|NN typically chance|NN inherit disease|NN huntingtin gene|NN provide genetic information|NN protein|NN call expansion|NN cytosine-adenine-guanine triplet|NN repeat|NN gene|NN code|NN huntingtin protein|NN result|NN abnormal protein|NN gradually damage cell|NN brain|NN mechanism|NN fully understood diagnosis|NN genetic test|NN carry time|NN regardless symptom|NN present fact|NN raise ethical debate|NN age|NN individual|NN consider mature choose test|NN parent|NN right|NN children|NN test manage confidentiality|NN disclosure|NN test|NN result|NN
cure|NN Huntington's disease|Disease full-time care|NN require later stage|NN disease|NN treatment|NN relieve symptom|NN improve quality|NN life|NN best evidence|NN treatment|NN movement|NN problem|NN Huntington's disease|Disease affect people|NN european descent|NN rare japanese|NN occurrence|NN rate|NN africa|NP unknown disease|NN affect men|NN women|NN equally complication|NN pneumonia|NN heart|NN disease|NN physical injury|NN fall|NN reduce life|NN expectancy|NN suicide|NN cause|NN death|NN case|NN death|NN typically occur year|NN disease|NN detect
likely description|NN disease|NN charles|NP oscar|NP waters|NP condition|NN describe further detail|NN physician|NN george|NP huntington|NP name genetic basis|NN discover international collaborative effort|NN led hereditary disease|NN foundation|NN research|NN support|NN organization|NN began form late increase public awareness|NN provide support|NN individual|NN family|NN promote research|NN current research|NN direction|NN include determine exact mechanism|NN disease|NN improve animal|NN model|NN aid|NN research|NN test|NN medication|NN treat symptom|NN slow progression|NN disease|NN study procedure|NN stem|NN cell|NN therapy|NN goal|NN repair damage|NN cause disease|NN content|NN
sign|NN symptom|NN genetics|NN genetic mutation|NN inheritance|NN mechanism|NN function|NN cellular change|NN change|NN diagnosis|NN clinical predictive|NN genetic test|NN genetic diagnosis|NN test|NN differential diagnosis|NN management|NN therapy|NN education|NN epidemiology|NN history|NN society|NN culture|NN ethics|NN support|NN organization|NN research|NN direction|NN reduce production|NN improve cell|NN survival|NN replacement|NN clinical trial|NN see reference|NN external link|NN
sign|NN symptom|NN report rate|NN behavioral symptom|NN Huntington's disease|Disease irritability|NN apathy|NN anxiety|NN depress mood|NN 3369|NN compulsive 1052|NN
symptom|NN Huntington's disease|Disease commonly become noticeable age|NN year|NN begin age|NN infancy|NN old age|NN early stage|NN subtle change|NN personality|NN cognition|NN physical skill|NN physical symptom|NN usually notice cognitive behavioral symptom|NN generally severe recognize earlier stage|NN Huntington's disease|Disease eventually exhibit similar physical symptom|NN onset|NN progression|NN extent|NN cognitive behavioral symptom|NN vary significantly individual|NN
characteristic initial physical symptom|NN jerky random uncontrollable movement|NN call chorea|NN initially exhibit general restlessness|NN small unintentionally initiate uncomplet motion|NN lack|NN coordination|NN slow eye|NN movement|NN minor motor|NN abnormality|NN usually precede obvious sign|NN motor|NN dysfunction|NN year|NN clear appearance|NN symptom|NN rigidity|NN writh motion|NN abnormal posture|NN appear disorder|NN progress sign|NN system|NN brain|NN responsible movement|NN affect function|NN become increasingly impair action|NN require muscle|NN control|NN affect
common consequence|NN physical instability|NN abnormal facial expression|NN difficulty|NN chew swallow|NN speak eate|NN difficulty|NN commonly cause|NN weight|NN loss|NN lead malnutrition|NN sleep|NN disturbance|NN associate symptom|NN juvenile|NN Huntington's disease|Disease differ symptom|NN generally progress faster exhibit briefly rigidity|NN dominant symptom|NN
common symptom|NN form|NN Huntington's disease|Disease
cognitive ability|NN progressively impair especially affect executive|NN function|NN include plan|NN cognitive flexibility|NN abstract think|NN rule|NN acquisition|NN initiation|NN appropriate action|NN inhibition|NN inappropriate action|NN disease|NN progress memory|NN deficit|NN tend appear
report impairment|NN range|NN short-term memory|NN deficit|NN long-term memory|NN difficulty|NN deficit|NN episodic memory|NN life|NN procedural memory|NN body|NN perform activity|NN work memory|NN cognitive problem|NN tend worsen time|NN ultimately lead dementia|NN pattern|NN deficit|NN call subcortical dementia|NN syndrome|NN distinguish typical effect|NN cortical dementia|NN eg
alzheimers|NP disease|NN
report manifestation|NN anxiety|NN depression|NN reduce display|NN emotion|NN blunt affect aggression|NN compulsive behavior|NN cause worsen addiction|NN alcoholism|NN gamble|NN hypersexuality|NN difficulty|NN recognize people|NN negative expression|NN observe prevalence|NN symptom|NN highly variable study|NN estimate rate|NN lifetime|NN prevalence|NN psychiatric disorder|NN sufferer|NN family|NN symptom|NN distress aspect|NN disease|NN affect daily function|NN constitute reason|NN institutionalization|NN thought|NN suicide|NN attempt|NN common general population|NN individual|NN reduce awareness|NN cognitive emotional impairment|NN
mutant|NN huntingtin|NN express body|NN associate abnormality|NN peripheral tissue|NN directly cause expression|NN brain|NN
abnormality|NN include muscle|NN atrophy|NN cardiac failure|NN impair glucose|NN tolerance|NN weight|NN loss|NN osteoporosis|NN testicular atrophy|NN genetics|NN
human|NN copy|NN huntingtin gene|NN code|NN protein|NN
gene|NN call Huntington's disease|Disease stand interest transcript|NN
part|NN gene|NN repeate section|NN call trinucleotide repeat|NN vary length|NN individual|NN change length|NN generation|NN
repeat|NN present healthy gene|NN dynamic mutation|NN increase repeat|NN count|NN result|NN defective gene|NN
length|NN repeate section|NN reache certain threshold|NN produce alter form|NN protein|NN call mutant|NN protein|NN
differ function|NN protein|NN cause|NN pathological change|NN turn|NN cause|NN disease|NN symptom|NN
Huntington's disease|Disease mutation|NN genetically dominant fully penetrant mutation|NN person|NN allele|NN cause disease|NN
inherit sex|NN length|NN repeate section|NN gene|NN severity|NN influence sex|NN affect parent|NN genetic mutation|NN
Huntington's disease|Disease trinucleotide repeat|NN disorder|NN cause length|NN repeate section|NN gene|NN exceed normal range|NN htt gene|NN locate short arm|NN chromosome|NN
contain sequence|NN dna|NN multiple time|NN ie
cagcagcag known trinucleotide repeat|NN cag|NN 3-letter genetic code|NN codon|NN amino|NN acid|NN glutamine|NN series|NN result|NN production|NN chain|NN glutamine|NN known polyglutamine tract|NN tract|NN repeate part|NN gene|NN polyq region|NN classification|NN trinucleotide repeat|NN result disease|NN status|NN number|NN cag repeat|NN repeat count|NN classification|NN disease|NN status|NN risk|NN offspr|NN normal affect none intermediate affect 3639|NN reduce affect full penetrance|NN affect
generally people|NN repeate glutamine|NN polyq region|NN result production|NN cytoplasmic protein|NN sequence|NN glutamine result|NN production|NN protein|NN different characteristics|NN alter form|NN call mutant|NN increase decay|NN rate|NN certain type|NN neuron|NN
region|NN brain|NN differ amount|NN reliance|NN type|NN neuron|NN affect accordingly generally number|NN cag repeat|NN relate process|NN affect account|NN variation|NN age|NN onset|NN symptom|NN
remain variation|NN attribute environment|NN gene|NN modify mechanism|NN Huntington's disease|Disease 3639|NN repeat result|NN reduced-penetrance form|NN disease|NN later onset|NN slower progression|NN symptom|NN
case|NN onset|NN late symptom|NN notice large repeat|NN count|NN Huntington's disease|Disease full penetrance|NN occur age|NN refer juvenile Huntington's disease|Disease variant|NN Huntington's disease|Disease
account|NN Huntington's disease|Disease carrier|NN inheritance|NN diagram|NN show father|NN carry gene|NN unaffect mother|NN lead offspr|NN affect affect show affect offspr|NN unaffect affect offspr|NN Huntington's disease|Disease inherit autosomal dominant fashion|NN
probability|NN offspr|NN inherit affect gene|NN
inheritance|NN independent gender|NN phenotype|NN skip generation|NN
Huntington's disease|Disease dominant inheritance|NN mean|NN affect individual|NN typically inherit copy|NN gene|NN expand trinucleotide|NN repeat mutant|NN allele|NN affect parent|NN penetrance|NN mutation|NN high mutate copy|NN gene|NN disease|NN
type|NN inheritance|NN pattern|NN offspr|NN affect individual|NN risk|NN inherit mutant|NN allele|NN therefore affect disorder|NN see figure|NN
probability|NN sex-independent
cag repeat|NN unstable replication|NN instability|NN increase|NN number|NN repeat|NN present usually lead new expansion|NN generation|NN pass dynamic mutation|NN instead reproduce exact copy|NN trinucleotide|NN repeat cause|NN number|NN repeat|NN change|NN successive generation|NN unaffect parent|NN intermediate number|NN repeat|NN reduce penetrance|NN pass copy|NN gene|NN increase|NN number|NN repeat|NN produce fully penetrant Huntington's disease|Disease increase|NN number|NN repeat|NN earlier age|NN onset|NN severity|NN disease|NN successive generation|NN known genetic anticipation|NN instability|NN greater inherit allele|NN usually similar repeat|NN length|NN inherit higher chance|NN increase length|NN rare Huntington's disease|Disease cause new mutation|NN parent|NN repeat|NN
rare situation|NN parent|NN expand Huntington's disease|Disease gene|NN risk|NN increase|NN parent|NN expand copy|NN risk|NN children|NN affect
individual|NN gene|NN affect rare
time|NN Huntington's disease|Disease thought disease|NN possession|NN mutate gene|NN affect symptom|NN progression|NN found affect phenotype|NN rate|NN progression|NN mechanism|NN
huntingtin protein|NN interact protein|NN appear multiple biological function|NN behavior|NN mutate protein|NN completely understood toxic certain cell|NN type|NN particularly brain|NN
early damage|NN evident striatum|NN disease|NN progress area|NN brain|NN conspicuously affect
early symptom|NN attributable function|NN striatum|NN cortical connectionsnamely|NN control|NN movement|NN mood|NN higher cognitive function|NN dna|NN methylation|NN appear change Huntington's disease|Disease huntingtin function|NN see
express cell|NN
highest concentration|NN found brain|NN teste|NN moderate amount|NN liver|NN heart|NN lung|NN function|NN htt|NN human|NN unclear
interact protein|NN involve transcription|NN cell|NN intracellular transport|NN animal|NN genetically modify exhibit Huntington's disease|Disease function|NN htt|NN found animal|NN important embryonic development|NN absence|NN relate embryonic death|NN
caspase enzyme|NN play role|NN apoptosis|NN thought activate mutate gene|NN damage ubiquitin-protease system|NN
act anti-apoptotic agent|NN prevent program cell|NN death|NN control production|NN neurotrophic factor|NN protein|NN protect neuron|NN regulate creation|NN
facilitate vesicular transport|NN synaptic transmission|NN control|NN neuronal gene|NN transcription|NN expression|NN htt|NN increase produce brain|NN cell|NN survival|NN improve effect|NN mhtt|NN reduce expression|NN htt|NN reduce result characteristics|NN typical presence|NN mhtt|NN thought disease|NN cause inadequate production|NN htt|NN increase|NN toxic function|NN mhtt|NN body|NN cellular change|NN closer view|NN neuron|NN large central core|NN tendril|NN branch core|NN contain orange blob|NN quarter|NN diameter|NN microscope|NN image|NN neuron|NN inclusion|NN stain orange|NN cause Huntington's disease|Disease image|NN width|NN
multiple cellular change|NN toxic function|NN mhtt|NN manifest produce Huntington's disease|Disease pathology|NN mutant|NN ie polyglutamine expand form|NN protein|NN prone cleavage|NN create shorter fragment|NN contain polyglutamine expansion|NN protein|NN fragment|NN propensity|NN undergo aggregation|NN yield aggregate|NN non-native polyglutamine|NN
-strand|NN multiple protein|NN bond together hydrogen|NN bond|NN aggregate|NN share fundamental cross-
amyloid architecture|NN seen protein|NN deposition|NN disease|NN
time|NN aggregate|NN accumulate form|NN inclusion|NN body|NN cell|NN ultimately interfer neuron|NN function|NN inclusion|NN run indirect interference|NN
inclusion|NN body|NN found cell|NN nucleus|NN cytoplasm|NN inclusion|NN body|NN cell|NN brain|NN earliest pathological change|NN experiment|NN found toxic cell|NN experiment|NN show form part|NN body defense|NN mechanism|NN help|NN protect cell|NN
pathway|NN cause cell|NN death|NN identify
include effect|NN chaperone|NN protein|NN help fold|NN protein|NN remove interaction|NN caspase|NN play role|NN process|NN remove cell|NN toxic effect|NN glutamine|NN nerve|NN cell|NN impairment|NN energy|NN production|NN cell|NN effect|NN expression|NN gene|NN
additional theory|NN explain way|NN cell|NN function|NN disrupt Huntington's disease|Disease propose damage|NN mitochondria|NN striatal cell|NN central importance|NN numerous account|NN mitochondrial metabolism|NN deficiency|NN found
mutant|NN protein|NN found play key role|NN mitochondrial dysfunction|NN impairment|NN mitochondrial electron|NN transport|NN result higher level|NN oxidative stress|NN release|NN reactive oxygen|NN specy|NN
interaction|NN alter huntingtin|NN protein|NN numerous protein|NN neuron|NN lead increase vulnerability|NN glutamine|NN large amount|NN found excitotoxin|NN
cause damage|NN numerous cellular structure|NN
glutamine|NN found excessively high amount|NN postulate increase vulnerability|NN even normal amount|NN glutamine|NN cause express change|NN diagram|NN sideview|NN brain|NN part|NN spinal cord|NN front|NN brain|NN left|NN centre|NN orange purple mass|NN quarter|NN size|NN whole brain|NN purple mass|NN largely overlap orange|NN arm|NN start leftmost region|NN form spiral|NN little way|NN taper end nodule|NN directly main mass|NN area|NN brain|NN damage early Huntington's disease|Disease show purple
Huntington's disease|Disease affect whole brain|NN certain area|NN vulnerable
prominent early effect|NN part|NN basal ganglia|NN call neostriatum|NN compose caudate nucleus|NN area|NN affect include substantia nigra|NN layer|NN cerebral cortex|NN hippocampus|NN cell|NN cerebellum|NN lateral tuberal|NN nucley|NN hypothalamus|NN part|NN thalamus|NN area|NN affect structure|NN type|NN neuron|NN contain reduce size|NN lose cell|NN spiny neuron|NN vulnerable particularly projection|NN external globus|NN interneuron|NN spiny cell|NN project internal pallidum|NN affect Huntington's disease|Disease cause abnormal increase|NN astrocyte|NN activation|NN brain|NN immune cell|NN
basal gangliathe|NN part|NN brain|NN prominently affect early Huntington's disease|Disease play key role|NN movement|NN behavior|NN control|NN
function|NN fully understood current theory|NN propose part|NN cognitive executive|NN system|NN motor|NN circuit|NN basal ganglia|NN ordinarily inhibit large number|NN circuit|NN generate specific movement|NN
initiate particular movement|NN cerebral cortex|NN send signal|NN basal ganglia|NN cause inhibition|NN release
damage basal ganglia|NN cause release|NN reinstatement|NN inhibition|NN erratic uncontrol result|NN awkward start|NN motion|NN motion|NN unintentionally initiate motion|NN halt intend completion|NN
accumulate damage|NN area|NN cause characteristic erratic movement|NN associate Huntington's disease|Disease spontaneous erratic physical movement|NN associate Huntington's disease|Disease classify type|NN hyperkinetic dysarthria|NN
basal ganglia|NN inability|NN inhibit movement|NN individual|NN affect inevitably experience reduce ability|NN produce speech|NN swallow|NN food|NN liquid|NN dysphagia|NN
protein|NN transcriptional coregulator|NN essential cell|NN function|NN coactivator|NN significant number|NN promoter|NN activate transcription|NN gene|NN survival|NN pathway|NN furthermore amino|NN acid|NN form|NN include strip|NN glutamine|NN
glutamine|NN cbp|NN interact directly increase number|NN glutamine|NN htt chain|NN cbp|NN get pull typical location|NN nucleus|NN specifically contain acetyltransferase domain|NN bind polyglutamine-contain domain|NN brain|NN Huntington's disease|Disease found incredibly reduce amount|NN cbp|NN addition|NN overexpress polyglutamine-induce death|NN diminish further demonstrate play important role|NN Huntington's disease|Disease neuron|NN general diagnosis|NN
medical diagnosis|NN onset|NN Huntington's disease|Disease made appearance|NN physical symptom|NN specific disease|NN genetic test|NN use confirm physical diagnosis|NN family|NN history|NN Huntington's disease|Disease
even onset|NN symptom|NN genetic test|NN confirm individual|NN embryo|NN carry expand copy|NN trinucleotide repeat|NN htt gene|NN cause disease|NN
genetic counsel|NN available provide advice|NN guidance|NN test|NN procedure|NN implication|NN confirm diagnosis|NN
implication|NN include impact|NN individual|NN psychology|NN career|NN family|NN plan|NN decision|NN relative|NN relationship|NN
availability|NN test|NN risk|NN inherit Huntington's disease|Disease choose clinical cross|NN section|NN brain|NN show undulate tissue|NN gap|NN large gap|NN evenly space centre|NN section|NN brain|NN scan|NN patient|NN Huntington's disease|Disease show|NN atrophy|NN head|NN caudate nucley|NN enlargement|NN frontal horn|NN lateral ventricle|NN ex|NN generalize cortical atrophy|NN
physical examination|NN sometime combine psychological examination|NN determine onset|NN disease|NN begun excessive unintentional movement|NN part|NN body|NN reason|NN seek medical consultation|NN
abrupt random time|NN distribution|NN suggest diagnosis|NN Huntington's disease|Disease
cognitive behavioral symptom|NN rarely symptom|NN diagnose usually recognize hindsight|NN develop further
far disease|NN progress measure use unify Huntington's disease|Disease rate|NN scale|NN provide overal rate|NN system|NN base motor|NN cognitive functional assessment|NN medical image|NN computerize tomography|NN ct|NN magnetic resonance|NN image|NN mry|NN show atrophy|NN caudate nucley|NN early disease|NN seen illustration|NN right|NN change|NN diagnostic Huntington's disease|Disease
cerebral atrophy|NN seen advance stage|NN disease|NN
functional neuroimage|NN technique|NN functional magnetic resonance|NN image|NN positron|NN emission|NN tomography|NN pet|NN show change|NN brain|NN activity|NN onset|NN physical symptom|NN experimental tool|NN use clinically genetic test|NN
Huntington's disease|Disease follow autosomal dominant pattern|NN inheritance|NN strong motivation|NN individual|NN risk|NN inherit seek diagnosis|NN
genetic test|NN Huntington's disease|Disease consist blood|NN test|NN count number|NN cag repeat|NN htt allele|NN give follow
repeat full penetrance|NN allele|NN positive test|NN positive result|NN generally refer case|NN
positive result|NN consider diagnosis|NN obtain decade|NN symptom|NN begin
negative test|NN mean individual|NN carry expand copy|NN gene|NN develop Huntington's disease|Disease test|NN tell person|NN originally percent|NN chance|NN inherit disease|NN risk|NN goe percent|NN eliminate
person|NN test positive disease|NN develop Huntington's disease|Disease sometime lifetime|NN live long disease|NN appear repeat|NN incomplete reduce penetrance|NN allele|NN
cause symptom|NN usually later adult|NN life|NN maximum risk|NN person|NN rpa|NN symptomatic age|NN year|NN risk|NN symptomatic age|NN year|NN repeat|NN intermediate allele|NN ia|NP large normal allele|NN
associate symptomatic disease|NN test individual|NN expand further inheritance|NN give symptom|NN offspr|NN repeat associate Huntington's disease|Disease
test|NN onset|NN symptom|NN life-chang event|NN personal decision|NN main reason|NN give choose|NN test|NN Huntington's disease|Disease aid|NN career|NN family|NN decision|NN available test|NN individual|NN learn carry huntington gene|NN
time|NN survey|NN indicate 5070|NN at-risk individual|NN interest receive test|NN predictive test|NN offer far choose test individual|NN risk|NN inherit Huntington's disease|Disease procee test|NN mostly treatment|NN key issue|NN anxiety|NN individual experience|NN know eventually develop Huntington's disease|Disease compare impact|NN positive result|NN result|NN stress|NN level|NN found lower year|NN test risk|NN suicide|NN increase positive test|NN result|NN individual|NN found inherit disorder|NN experience survivor|NN guilt|NN regard|NN family|NN member|NN affect factor|NN taken account|NN consider test|NN include possibility|NN discrimination|NN implication|NN positive result|NN usually mean parent|NN affect gene|NN individual|NN sible|NN risk|NN inherit study|NN genetic discrimination|NN found individual|NN risk|NN Huntington's disease|Disease
occure higher rate|NN personal relationship|NN health|NN insurance|NN employment|NN relation|NN genetic counsel|NN Huntington's disease|Disease provide information|NN advice|NN support|NN initial decision-make|NN chosen stage|NN test|NN process|NN implication|NN test|NN patient|NN wish undergo test|NN complete counsel session|NN provide information|NN
guideline|NN use|NN genetic test|NN Huntington's disease|Disease become model|NN genetic disorder|NN dominant cerebellar|NN test|NN Huntington's disease|Disease influence test|NN illness|NN genetic variant|NN kidney|NN disease|NN familial alzheimers|NP disease|NN breast|NN cancer|NN european molecular genetics|NN quality|NN network|NN publish yearly external quality|NN assessment|NN scheme|NN molecular genetic test|NN disease|NN develop best practice|NN guideline|NN genetic test|NN Huntington's disease|Disease assist test|NN report|NN result|NN genetic diagnosis|NN
embryo|NN produce use fertilization|NN genetically test Huntington's disease|Disease use genetic diagnosis|NN
technique|NN cell|NN extract typically 4- embryo|NN test genetic abnormality|NN use ensure embryo|NN affect Huntington's disease|Disease gene|NN implant therefore offspr|NN inherit disease|NN
form|NN genetic diagnosisnon-disclosure|NN exclusion|NN people|NN Huntington's disease|Disease -free offspr|NN reveal parental genotype|NN give information|NN destine develop Huntington's disease|Disease
exclusion|NN test embryo|NN dna|NN compare parent|NN grandparent|NN avoid inheritance|NN chromosomal region|NN contain Huntington's disease|Disease gene|NN affect grandparent|NN
non-disclosure|NN test|NN embryo|NN replace uterus|NN parental genotype|NN parental risk|NN Huntington's disease|Disease disclose test|NN
possible obtain prenatal diagnosis|NN embryo|NN fetus|NN womb|NN use fetal genetic material|NN acquire chorionic villus sample|NN
amniocentesis|NN perform pregnancy|NN further along week|NN
procedure|NN look amniotic fluid|NN surround baby|NN indicator|NN Huntington's disease|Disease mutation|NN pair exclusion|NN test|NN avoid disclosure|NN parental genotype|NN
test|NN parent|NN diagnose Huntington's disease|Disease genetic test|NN show expansion|NN htt gene|NN chance|NN inherit disease|NN
parent|NN counsel option|NN include termination|NN pregnancy|NN difficulty|NN child|NN identify gene|NN
addition|NN at-risk pregnancy|NN due affect male partner|NN non-invasive prenatal diagnosis|NN perform analyze fetal dna|NN blood|NN sample|NN taken mother|NN venipuncture|NN week|NN pregnancy|NN procedure-relate risk|NN miscarriage|NN except needle|NN contamination|NN differential diagnosis|NN
Huntington's disease|Disease diagnose|NN base typical symptom|NN family|NN history|NN disease|NN confirm genetic test|NN expand trinucleotide|NN repeat cause|NN Huntington's disease|Disease
remain call Huntington's disease|Disease -like Huntington's disease|Disease l|NP syndrome|NN cause|NN Huntington's disease|Disease disease|NN unknown known cause|NN due mutation|NN prion|NN protein|NN gene|NN Huntington's disease|Disease junctophilin gene|NN Huntington's disease|Disease recessively|NN inherit unknown gene|NN Huntington's disease|Disease l3only|NN found family|NN poorly understood gene|NN encod tata|NN protein|NN sometime call Huntington's disease|Disease
dominant disease|NN misdiagnose Huntington's disease|Disease atrophy|NN neuroferritinopathy|NN
autosomal recessive disorder|NN resemble sporadic case|NN Huntington's disease|Disease
include acanthocytosis|NN kinase-associate neurodegeneration|NN
x-link disorder|NN type|NN mcleod|NP syndrome|NN management|NN diagram|NN show carbon|NN hydrogen|NN oxygen|NN nitrogen|NN atom|NN bond together chemical structure|NN tetrabenazine|NN approve compound|NN management|NN chorea|NN Huntington's disease|Disease
cure|NN Huntington's disease|Disease treatment|NN available reduce severity|NN symptom|NN treatment|NN evidence|NN confirm effectiveness|NN treate symptom|NN Huntington's disease|Disease specifically incomplete disease|NN progress ability|NN care|NN decline carefully manage multidisciplinary caregive|NN become increasingly necessary relatively study|NN exercise|NN therapy|NN help|NN rehabilitate cognitive symptom|NN Huntington's disease|Disease evidence|NN usefulness|NN physical therapy|NN occupational therapy|NN speech|NN therapy|NN association|NN caffeine|NN intake|NN earlier age|NN onset|NN Huntington's disease|Disease found find|NN base retrospective questionnaire|NN data|NN blind randomize trial|NN case-control study|NN work|NN poor basis|NN guide lifestyle|NN decision|NN therapy|NN
weight|NN loss|NN eate|NN difficulty|NN due dysphagia|NN muscle|NN common make|NN nutrition|NN management|NN increasingly important disease|NN advance|NN agent|NN ad liquid|NN thicker fluid|NN easier safer swallow affect person|NN eat slowly take smaller piece|NN food|NN mouth|NN use|NN prevent choke eate|NN become hazardous uncomfortable option|NN use percutaneous endoscopic gastrostomy|NN available
feed tube|NN permanently attach abdomen|NN stomach|NN reduce risk|NN food|NN provide better nutritional management|NN assessment|NN management|NN speech-language pathologist|NN experience|NN Huntington's disease|Disease recommend
people|NN Huntington's disease|Disease see physical therapist|NN non-invasive non-medication-base way|NN manage physical symptom|NN
physical therapist|NN implement fall|NN risk|NN assessment|NN prevention|NN well strengthen|NN stretch|NN cardiovascular exercise|NN
walk|NN aid|NN prescribe appropriate
physical therapist|NN prescribe breath|NN exercise|NN airway|NN clearance|NN technique|NN development|NN respiratory problem|NN consensus|NN guideline|NN physiotherapy|NN Huntington's disease|Disease produce european Huntington's disease|Disease network|NN goal|NN early rehabilitation|NN intervention|NN prevention|NN loss|NN function|NN
participation|NN rehabilitation|NN program|NN early middle stage|NN disease|NN beneficial translate long term|NN maintenance|NN motor|NN functional performance|NN
rehabilitation|NN late stage|NN aim compensate motor|NN functional loss|NN long-term independent management|NN therapist|NN develop home|NN exercise|NN program|NN appropriate people|NN
additionally increase number|NN people|NN Huntington's disease|Disease turn palliative care|NN aim improve quality|NN life|NN treatment|NN symptom|NN stress|NN serious illness|NN addition|NN treatment|NN
approve treatment|NN chorea|NN Huntington's disease|Disease eu|NN 2008|NN drug|NN help reduce include benzodiazepine|NN compound|NN investigation|NN show preliminary positive result|NN rigidity|NN especially juvenile case|NN treate antiparkinsonian drug|NN hyperkinesia|NN treate acid|NN
psychiatric symptom|NN treate medication|NN similar use general population|NN selective serotonin|NN reuptake|NN inhibitor|NN mirtazapine|NN recommend depression|NN atypical antipsychotic|NN drug|NN recommend psychosis|NN behavioral|NN problem|NN specialist|NN input|NN recommend people|NN require long-term treatment|NN multiple medication|NN combination|NN education|NN
family|NN individual|NN society|NN large inherit risk|NN inherit Huntington's disease|Disease generation|NN experience|NN Huntington's disease|Disease unaware recent breakthrough|NN understand|NN disease|NN availability|NN genetic test|NN
genetic counsel|NN benefit|NN individual|NN update knowledge|NN seek dispel unfound belief|NN help consider future|NN option|NN plan|NN
cover information|NN family|NN plan|NN choice|NN care|NN management|NN consideration|NN
length|NN trinucleotide repeat|NN account|NN variation|NN age|NN symptom|NN appear rate|NN progress
longer repeat|NN result|NN earlier age|NN onset|NN faster progression|NN symptom|NN individual|NN repeat|NN develop disease|NN age|NN repeat|NN ever develop noticeable symptom|NN remain variation|NN due environmental factor|NN gene|NN influence mechanism|NN disease|NN
life|NN expectancy|NN Huntington's disease|Disease generally year|NN onset|NN visible symptom|NN life-threaten complication|NN result|NN muscle|NN coordination|NN lesser extent|NN change|NN induce decline cognitive function|NN
largest risk|NN pneumonia|NN cause death|NN Huntington's disease|Disease
ability|NN synchronize movement|NN deteriorate difficulty|NN clear lung|NN increase risk|NN food|NN drink|NN increase|NN risk|NN contract pneumonia|NN
greatest risk|NN heart|NN disease|NN cause quarter|NN fatality|NN Huntington's disease|Disease suicide|NN greatest cause|NN fatality|NN Huntington's disease|Disease take live|NN attempt
unclear extent|NN suicidal thought|NN influence behavioral symptom|NN signify sufferer|NN desire|NN avoid later stage|NN disease|NN associate risk|NN include choke physical injury|NN fall|NN malnutrition|NN epidemiology|NN
late onset|NN Huntington's disease|Disease mean usually affect reproduction|NN worldwide prevalence|NN Huntington's disease|Disease case|NN person|NN vary greatly geographically result|NN ethnicity|NN local migration|NN past|NN immigration|NN pattern|NN prevalence|NN similar men|NN women|NN
rate|NN occurrence|NN highest people|NN western european descent|NN average people|NN lower rest|NN world|NN eg people|NN asian african descent|NN
2013 epidemiological study|NN prevalence|NN Huntington's disease|Disease uk|NP found average prevalence|NN uk|NP additionally localize area|NN higher prevalence|NN regional average|NN highest incidence|NN isolate population|NN lake|NN region|NN venezuela|NP Huntington's disease|Disease affect person|NN area|NN high localization|NN found tasmania|NP specific region|NN scotland|NP wales|NP sweden|NP increase prevalence|NN case|NN occur due local founder|NN effect|NN historical migration|NN carrier|NN area|NN geographic isolation|NN carrier|NN trace back year|NN use genealogical study|NN genetic haplotype|NN give clue|NN geographic variation|NN prevalence|NN iceland|NP contrary|NN low prevalence|NN fact|NN icelander people|NN descend early germanic tribe|NN scandinavia|NP gave rise|NN swede|NN case|NN exception|NN go back nearly century|NN derive offspr|NN couple|NN live early century|NN finland|NP well low incidence|NN people|NN
discovery|NN genetic test|NN statistics|NN include clinical diagnosis|NN base physical symptom|NN family|NN history|NN Huntington's disease|Disease dy cause|NN diagnosis|NN
case|NN include statistics|NN test|NN become widely available estimate|NN prevalence|NN incidence|NN disorder|NN likely increase history|NN right|NN young man|NN dress suit|NN tie|NN sport moustache|NN tuft|NN hair|NN chin|NN left|NN top half|NN medical journal|NN title medical surgical reporter|NN george|NP huntington|NP describe disorder|NN paper|NN chorea|NN age|NN
recognize disorder|NN middle age|NN cause|NN unknown fairly recently
give different name|NN history|NN understand|NN disease|NN change
originally call simply jerky dancelike|NN movement|NN associate disease|NN Huntington's disease|Disease call hereditary chronic progressive chorea|NN definite mention|NN Huntington's disease|Disease letter|NN charles|NP oscar|NP waters|NP publish edition|NN dunglison practice|NN medicine|NN
waters|NP describe form|NN vulgarly|NN call magrum accurate description|NN chorea|NN progression|NN strong heredity|NN disease|NN charles|NP gorman|NP observe higher prevalence|NN seem occur localize region|NN independently gorman|NP waters|NP student|NN dunglison|NN jefferson|NP medical college|NN philadelphia|NP johan|NP christian|NP lund|NP produce early description|NN specifically note seclude mountain|NN valley|NN norway|NP high prevalence|NN dementia|NN associate pattern|NN jerk|NN movement|NN disorder|NN ran family|NN
thorough description|NN disease|NN george|NP huntington|NP
examine combine medical history|NN generation|NN family|NN exhibit similar symptom|NN realize condition|NN link present detail accurate definition|NN disease|NN paper|NN
huntington|NP describe exact pattern|NN inheritance|NN dominant disease|NN year|NN rediscovery|NN scientist|NN mendelian inheritance|NN
hereditary nature|NN
parent|NN show manifestation|NN disease|NN offspr|NN invariably suffer disease|NN
chance|NN children|NN go life|NN thread|NN broken grandchildren|NN great-grandchildren|NN original shaker|NN rest assure free disease|NN
sir|NP william|NP interest disorder|NN chorea|NN general impress paper|NN state history|NN medicine|NN instance|NN disease|NN accurately graphically briefly describe
continue interest|NN Huntington's disease|Disease combine influence|NN field|NN medicine|NN help rapidly spread|NN awareness|NN knowledge|NN disorder|NN medical community|NN great interest|NN show scientist|NN europe|NP louis|NP joseph|NP landouzy|NP bourneville|NP camillo|NP joseph|NP jules|NP end|NN century|NN research|NN Huntington's disease|Disease european origin|NN end|NN century|NN research|NN report|NN Huntington's disease|Disease publish country|NN disease|NN recognize worldwide condition|NN
rediscovery|NN mendelian inheritance|NN turn|NN century|NN Huntington's disease|Disease use tentatively example|NN dominant inheritance|NN english biologist|NN william|NP bateson|NP use pedigree|NN affect family|NN establish Huntington's disease|Disease autosomal dominant inheritance|NN pattern|NN strong inheritance|NN pattern|NN prompt researcher|NN smith|NP ely|NP attempt|NN trace|NN connect family|NN member|NN previous study|NN collect information|NN new|NP york|NP publish article|NN genealogy|NN Huntington's disease|Disease new|NP england|NP research|NN rouse interest|NN college|NN friend|NN charles|NP davenport|NP commission elizabeth|NP produce field|NN study|NN east|NN coast|NN unit state|NN family|NN Huntington's disease|Disease construct pedigree|NN davenport|NP use information|NN document variable|NN age|NN onset|NN range|NN symptom|NN Huntington's disease|Disease claim case|NN Huntington's disease|Disease usa|NP trace back handful|NN individual|NN research|NN further embellish p|NP
popularize idea|NN brother|NN left england|NP bound boston|NP progenitor|NN Huntington's disease|Disease usa|NP claim|NN earliest progenitor|NN establish eugenic bia|NN muncey|NN work|NN contribute misunderstand|NN prejudice|NN Huntington's disease|Disease muncey|NN davenport|NP popularize idea|NN past|NN Huntington's disease|Disease sufferer|NN thought possess spirit|NN victim|NN witchcraft|NN sometime shun exil society|NN idea|NN proven
researcher|NN found evidence|NN instance|NN community|NN family|NN study george|NP huntington|NP openly accommodate exhibit symptom|NN Huntington's disease|Disease
search|NN cause|NN condition|NN enhance considerably hereditary disease|NN foundation|NN Huntington's disease|Disease f|NP create milton|NP psychoanalyst|NN base los|NP angeles|NP california|NP wife|NN sabin|NP diagnose earlier year|NN Huntington's disease|Disease brother|NN wife|NN suffer disease|NN
foundation|NN involve recruitment|NN scientist|NN Huntington's disease|Disease collaborative research|NN project|NN 10-year period|NN work locate responsible gene|NN
thank|NN Huntington's disease|Disease f|NP ongo us-venezuela|NN Huntington's disease|Disease collaborative research|NN project|NN start report major breakthrough|NN discovery|NN approximate location|NN causal gene|NN result|NN extensive study|NN focuse population|NN isolate venezuelan village|NN laguneta unusually high prevalence|NN disease|NN
involve peoplemostly|NN single extend family|NN
innovation|NN project|NN develop method|NN important step|NN make human genome|NN project|NN possible research|NN group|NN isolate precise causal gene|NN make|NN autosomal|NN disease|NN locus|NN found use genetic linkage|NN analysis|NN
time|NN frame|NN key|NN discovery|NN mechanism|NN disorder|NN made find|NN anita|NP research|NN group|NN effect|NN gene|NN length|NN
model disease|NN various type|NN animal|NN transgenic mouse|NN develop enable larger scale|NN experiment|NN
animal|NN faster metabolism shorter lifespan|NN human|NN result|NN experiment|NN receive sooner speed research|NN
discovery|NN fragment|NN led discovery|NN nuclear inclusion|NN cause
advance|NN led increasingly extensive research|NN protein|NN involve disease|NN potential|NN drug|NN treatment|NN care|NN method|NN gene|NN
condition|NN formerly call Huntington's disease|Disease term|NN replace Huntington's disease|Disease patient|NN develop chorea due importance|NN cognitive behavioral problem|NN society|NN culture|NN see list|NN Huntington's disease|Disease media|NN depiction|NN ethics|NN see fertilisation|NN ethics|NN stem|NN cell|NN controversy|NN
Huntington's disease|Disease particularly application|NN genetic test|NN disease|NN raise ethical issue|NN
issue|NN genetic test|NN include define mature individual|NN consider eligible test|NN ensure confidentiality|NN result|NN company|NN allow use|NN test|NN result|NN decision|NN employment|NN life|NN insurance|NN financial matter|NN
controversy|NN charles|NP davenport|NP propose compulsory sterilization|NN immigration|NN control|NN use people|NN certain disease|NN Huntington's disease|Disease part|NN eugenics|NN movement|NN fertilization|NN issue|NN use|NN embryo|NN
Huntington's disease|Disease research|NN ethical issue|NN due use|NN animal|NN test|NN embryonic stem|NN cell|NN
development|NN accurate diagnostic test|NN Huntington's disease|Disease cause social legal ethical concern|NN access|NN use|NN person|NN result|NN guideline|NN test|NN procedure|NN strict procedure|NN disclosure|NN confidentiality|NN allow individual|NN decide receive result|NN result|NN made available financial institution|NN business|NN face question|NN use genetic test|NN result|NN assess individual|NN life|NN insurance|NN employment|NN
unit kingdom|NN insurance|NN company|NN agree department|NN health|NN social care|NN customer|NN need disclose predictive genetics|NN test|NN agreement|NN explicitly exclude government-approve test|NN huntington|NN write|NN policy|NN value|NN gb500000|NN untreatable genetic condition|NN later onset|NN ethically questionable perform test|NN child|NN adolescent|NN medical benefit|NN individual|NN
consensus|NN test individual|NN consider cognitively mature counter-argument|NN parent|NN right|NN make decision|NN child behalf|NN
lack|NN effective treatment|NN test person|NN legal age|NN judge competent consider unethical case|NN
ethical concern|NN relate prenatal genetic test|NN genetic diagnosis|NN ensure child|NN born give disease|NN example|NN prenatal test|NN raise issue|NN selective abortion|NN choice|NN consider unacceptable dominant disease|NN difficulty|NN situation|NN parent|NN want know diagnosis|NN
require part|NN process|NN kept secret parent|NN support|NN organization|NN black-and-white photograph|NN taken indoor woody|NP guthrie|NP wear|NN pinstripe|NN trouser|NN tartan shirt|NN top button|NN undone cap|NN
sit play six-str acoustic guitar|NN support knee|NN appear sing
machine|NN fascist|NN written capital|NN letter|NN rectangular sticker|NN fix guitar|NN
death|NN woody|NP guthrie|NP led foundation|NN committee|NN combat|NN Huntington's disease|Disease
experience Huntington's disease|Disease wife family|NN dr|NP
milton|NP wexler|NP inspire start hereditary disease|NN foundation|NN Huntington's disease|Disease f|NP aim|NN cure genetic illness|NN coordinate support research|NN foundation|NN daughter|NN nancy|NP wexler|NP key part|NN research|NN team|NN venezuela|NP discover Huntington's disease|Disease gene|NN
roughly time|NN Huntington's disease|Disease f|NP form marjorie|NP guthrie|NP help found committee|NN combat|NN Huntington's disease|Disease Huntington's disease|Disease society|NN america|NP husband|NN woody|NP guthrie|NP dy complication|NN Huntington's disease|Disease
support|NN research|NN organization|NN form country|NN world|NN help increase public awareness|NN Huntington's disease|Disease
number|NN collaborate umbrella|NN organization|NN international huntington|NP association|NN european Huntington's disease|Disease network|NN support|NN organization|NN hold annual Huntington's disease|Disease awareness|NN event|NN endorse respective government|NN
example|NN june|NP designate national Huntington's disease|Disease awareness|NN day|NN senate|NN
largest funder|NN Huntington's disease|Disease research|NN globally term|NN financial expenditure|NN Huntington's disease|Disease foundation|NN non-profit biomedical foundation|NN aim rapidly discover develop drug|NN delay|NN slow Huntington's disease|Disease c|NP Huntington's disease|Disease formerly known high q|NN foundation|NN
spent Huntington's disease|Disease research|NN c|NP Huntington's disease|Disease collaborate academic commercial laboratory|NN globally engage oversight|NN management|NN research|NN project|NN well fund|NN organization|NN exist support|NN inform affect Huntington's disease|Disease
research|NN direction|NN
research|NN mechanism|NN Huntington's disease|Disease focuse identify function|NN htt|NN differ interfere brain|NN pathology|NN disease|NN produce
research|NN conduct use method|NN animal|NN model|NN human volunteer|NN
animal|NN model|NN critical understand fundamental mechanism|NN cause disease|NN support early stage|NN drug|NN development|NN animal|NN chemically induce brain|NN injury|NN exhibit|NN Huntington's disease|Disease -like symptom|NN initially use mimic progressive feature|NN disease|NN identification|NN causative gene|NN enable development|NN transgenic animal|NN model|NN nematode|NN worm|NN drosophila|NP fruit|NN fly|NN mice|NN rat|NN sheep|NN pig|NN monkey|NN express mutant|NN develop progressive neurodegeneration|NN Huntington's disease|Disease -like symptom|NN
research|NN conduct different approache|NN prevent Huntington's disease|Disease slow progression|NN
strategy|NN broadly group category|NN reduce level|NN mutant|NN protein|NN gene|NN splice|NN gene|NN silence|NN approache|NN aim improve neuronal survival|NN reduce harm|NN cause protein|NN specific cellular pathway|NN mechanism|NN protein|NN homeostasis|NN histone|NN inhibition|NN strategy|NN replace lost neuron|NN
addition|NN novel|NN therapy|NN improve brain|NN function|NN development|NN seek produce symptomatic therapy|NN include inhibitor|NN reduce production|NN
gene|NP silence|NN aim reduce production|NN mutant|NN protein|NN Huntington's disease|Disease cause single dominant gene|NN encod toxic protein|NN
gene|NP silence|NN experiment|NN mouse|NN model|NN show expression|NN mhtt|NN reduce symptom|NN improve safety|NN specific rnay|NN gene|NN silence|NN demonstrate mice|NN large human-like|NN brain|NN primate|NN silence attempt|NN silence|NN mutant|NN leave wild-type untouch
way|NN accomplish identify polymorphism|NN present allele|NN produce|NN gene|NN silence|NN drug|NN target|NN polymorphism|NN mutant|NN allele|NN gene|NN silence|NN trial|NN involve human Huntington's disease|Disease patient|NN began test|NN safety|NN ionis-httrx|NN produce ionis pharmaceutical|NN led ucl|NP institute|NN mutant|NN huntingtin|NN detect quantify time|NN cerebrospinal fluid|NN Huntington's disease|Disease mutation-carrier|NN use novel|NN count|NN immunoassay|NN provide direct way|NN assess treatment|NN achieve desire effect|NN similarly gene|NN splice|NN technique|NN look try repair genome|NN erroneous gene|NN cause|NN Huntington's disease|Disease use tool|NN improve cell|NN survival|NN
approache|NN aim improve cell|NN survival|NN presence|NN mutant|NN huntingtin|NN correction|NN transcriptional regulation|NN use histone|NN inhibitor|NN modulate aggregation|NN improve metabolism|NN mitochondrial function|NN restor function|NN synapse|NN replacement|NN
stem|NN cell|NN therapy|NN replacement|NN damage neuron|NN transplantation|NN stem|NN cell|NN affect region|NN brain|NN
experiment|NN yield mix result|NN use technique|NN animal|NN model|NN preliminary human clinical trial|NN future therapeutic potential|NN stem|NN cell|NN valuable tool|NN study Huntington's disease|Disease laboratory|NN clinical trial|NN
clinical trial|NN new experimental treatment|NN underway plan Huntington's disease|Disease
compound|NN fail prevent slow progression|NN Huntington's disease|Disease human trial|NN include coenzyme|NN creatine minocycline|NN ethyl-epa|NN see
Huntington's disease|Disease association|NN
