free encyclopedia|NN jump|NN navigation|NN jump|NN search article|NN psychiatric condition|NN
information|NN trait|NN see
Narcissistic personality disorder|Disease redirect
use|NN see Narcissistic personality disorder|Disease disambiguation|NN
Narcissistic personality disorder|Disease name|NN Narcissistic personality disorder|Disease man|NN look pool|NN water|NN narcissus|NP caravaggio|NP gaze reflection|NN psychiatry|NN psychology|NN symptom|NN feel|NN self-importance|NN excessive need|NN admiration|NN lack|NN understand|NN feel|NN usual onset|NN early adulthood|NN duration|NN long term|NN cause|NN unknown differential diagnosis|NN disorder|NN substance|NN abuse|NN depressive|NN disorder|NN anxiety|NN disorder|NN treatment|NN difficult frequency|NN personality|NN disorder|NN cluster|NN odd
schizoid schizotypal|NN
cluster|NN dramatic
cluster|NN anxious
dependent obsessivecompulsive|NN
haltlose|NN self-defeate psychopathic|NN
Narcissistic personality disorder|Disease Narcissistic personality disorder|Disease personality|NN disorder|NN long-term pattern|NN abnormal behavior|NN characterize exaggerate feel|NN self-importance|NN excessive need|NN admiration|NN lack|NN empathy|NN affect spend time|NN think|NN achieve power|NN success|NN appearance|NN take advantage|NN people|NN behavior|NN typically begin early adulthood|NN occur variety|NN social situation|NN
cause|NN Narcissistic personality disorder|Disease unknown personality|NN disorder|NN classify cluster|NN diagnostic statistical manual|NN mental disorder|NN dsm|NP diagnosis|NN made healthcare|NN professional|NN interview person|NN question|NN condition|NN need differentiate mania|NN substance|NN use|NN disorder|NN
treatment|NN well study therapy|NN difficult people|NN disorder|NN frequently consider problem|NN percent|NN people|NN believe affect point|NN life|NN appear occur male|NN female|NN affect young people|NN older people|NN personality|NN describe robert|NP term|NN Narcissistic personality disorder|Disease came use|NN content|NN
sign|NN symptom|NN associate feature|NN cause|NN genetic environment|NN diagnosis|NN treatment|NN epidemiology|NN history|NN early object|NN relation|NN society|NN culture|NN fiction|NN criticism|NN see reference|NN further read|NN external link|NN
sign|NN symptom|NN
people|NN Narcissistic personality disorder|Disease Narcissistic personality disorder|Disease characterize persistent excessive need|NN admiration|NN personal disdain|NN lack|NN empathy|NN person|NN Narcissistic personality disorder|Disease usually display arrogance|NN distort sense|NN superiority|NN seek establish abusive power|NN control|NN strong sense|NN self|NN different Narcissistic personality disorder|Disease people|NN Narcissistic personality disorder|Disease typically value|NN extent|NN openly disregard feel|NN wishe|NN expect treate superior|NN regardless actual status|NN achievement|NN moreover person|NN Narcissistic personality disorder|Disease usually exhibit fragile ego|NN self-concept|NN intolerance|NN criticism|NN tendency|NN belittle order|NN validate superiority|NN
dsm-5|NN indicate person|NN Narcissistic personality disorder|Disease usually display follow symptom|NN typically commensurate quality|NN accomplishment|NN
grandiosity expectation|NN superior treatment|NN people|NN fantasy|NN power|NN success|NN intelligence|NN attractiveness|NN
self-perception|NP unique superior associate high-status people|NN institution|NN need continual admiration|NN sense|NN entitlement|NN special treatment|NN obedience|NN exploitation|NN achieve personal gain|NN empathize feel|NN wishe|NN need|NN people|NN intense envy|NN belief|NN equally envious constantly demean bully|NN belittle
Narcissistic personality disorder|Disease usually develop adolescence|NN early adulthood|NN uncommon children|NN adolescent|NN display|NN trait|NN similar Narcissistic personality disorder|Disease occurrence|NN usually transient criteria|NN diagnosis|NN Narcissistic personality disorder|Disease true symptom|NN Narcissistic personality disorder|Disease pervasive apparent vary situation|NN rigid remain consistent time|NN
Narcissistic personality disorder|Disease symptom|NN sufficiently severe significantly impair person|NN capability|NN develop meaningful human relationship|NN
generally symptom|NN Narcissistic personality disorder|Disease impair person|NN psychological ability|NN function|NN work|NN school|NN important social set|NN
dsm-5|NN indicate trait|NN manifest person|NN substantially differ cultural norm|NN order|NN qualify symptom|NN Narcissistic personality disorder|Disease associate feature|NN
people|NN Narcissistic personality disorder|Disease tend exaggerate skill|NN accomplishment|NN level|NN intimacy|NN people|NN consider high-status
sense|NN superiority|NN cause monopolize conversation|NN become impatient disdainful talk ego|NN wound real perceive criticism|NN anger|NN disproportionate situation|NN typically action|NN response|NN deliberate calculate occasional flare-up|NN insecurity|NN self-image|NN primarily stable ie
extent|NN people|NN pathologically narcissistic control blame self-absorb intolerant view|NN unaware need|NN effect|NN behavior|NN insist see wish seen individual|NN use various strategy|NN protect self|NN expense|NN
tend devalue derogate insult|NN blame|NN respond threaten feedback|NN anger|NN hostility|NN fragile ego|NN individual|NN Narcissistic personality disorder|Disease hypersensitive perceive criticism|NN defeat|NN prone feel|NN shame|NN humiliation|NN worthlessness|NN minor even imagine incident|NN usually mask feel|NN feign humility|NN isolate socially react outburst|NN rage|NN defiance|NN seek revenge|NN merge|NN inflate self-concept|NN actual self|NN seen inherent grandiosity|NN Narcissistic personality disorder|Disease
inherent process|NN defense|NN mechanism|NN denial|NN idealization|NN devaluation|NN
dsm-5|NN highly successful individual|NN display|NN personality|NN trait|NN consider narcissistic
trait|NN inflexible maladaptive persist cause|NN significant functional impairment|NN subjective distress|NN constitute Narcissistic personality disorder|Disease
due high-functionality|NN associate narcissism|NN people|NN view impairment|NN live|NN tend make individual|NN Narcissistic personality disorder|Disease ambitious necessarily lead success|NN high achievement|NN professionally
individual|NN unwil compete refuse take risk|NN order|NN avoid appear failure|NN addition|NN inability|NN tolerate disagreement|NN criticism|NN lack|NN empathy|NN make difficult individual|NN work cooperatively maintain long-term professional relationship|NN superior|NN colleague|NN cause|NN
cause|NN Narcissistic personality disorder|Disease unknown expert|NN tend apply biopsychosocial model|NN causation|NN mean|NN combination|NN environmental social genetic neurobiological factor|NN likely play role|NN formulate narcissistic personality|NN genetic
evidence|NN Narcissistic personality disorder|Disease heritable individual|NN likely develop Narcissistic personality disorder|Disease family|NN history|NN disorder|NN study|NN occurrence|NN personality|NN disorder|NN twin|NN determine moderate high heritability|NN Narcissistic personality disorder|Disease
specific gene|NN gene|NN interaction|NN contribute causeand|NN influence developmental physiological process|NN underly conditionhave|NN determine
environmental social factor|NN thought significant influence|NN onset|NN Narcissistic personality disorder|Disease people|NN pathological narcissism|NN develop impair attachment|NN primary caregiver|NN usually parent|NN result child perception|NN himselfherself|NN unimportant unconnect
child|NN typically come believe personality|NN defect|NN make unwant permissive parent|NN well insensitive over-control|NN parent|NN believe contribute factor|NN
leonard|NP arnold|NP cooper|NP follow identify various researcher|NN possible factor|NN promote development|NN Narcissistic personality disorder|Disease
oversensitive temperament|NN personality|NN trait|NN birth|NN
excessive admiration|NN balance realistic feedback|NN
excessive praise|NN good behavior|NN excessive criticism|NN bad behavior|NN childhood|NN
overvaluation parent|NN family|NN member|NN peer|NN
praise perceive exceptional look|NN ability|NN adult|NN
severe emotional abuse|NN childhood|NN
unreliable caregive|NN parent|NN
learn|NN manipulative behavior|NN parent|NN peer|NN
cultural element|NN believe influence prevalence|NN Narcissistic personality disorder|Disease well Narcissistic personality disorder|Disease trait|NN found common modern society|NN traditional
research|NN neurological underpine|NN Narcissistic personality disorder|Disease
recent research|NN identify structural abnormality|NN brain|NN Narcissistic personality disorder|Disease specifically note volume|NN gray matter|NN left anterior insula|NN study|NN associate condition|NN reduce gray matter|NN prefrontal cortex|NN
brain|NN region|NN identify above study|NN associate empathy|NN compassion|NN emotional regulation|NN cognitive function|NN
find|NN suggest Narcissistic personality disorder|Disease relate compromise capacity|NN emotional empathy|NN emotional regulation|NN diagnosis|NN
formulation|NN Narcissistic personality disorder|Disease american psychiatric association|NN apa|NP diagnostic statistical manual|NN mental disorder|NN edition|NN text|NN revision|NN criticise fail describe range|NN complexity|NN disorder|NN
critics|NN said focuse overly narcissistic individual|NN external symptomatic social interpersonal patternsat|NN expense|NN internal complexity|NN individual suffer|NN argue reduce clinical utility|NN
personality|NN personality|NN disorder|NN work|NN group|NN originally propose elimination|NN Narcissistic personality disorder|Disease distinct disorder|NN dsm-5|NN part|NN major revamp|NN diagnostic criteria|NN personality|NN disorder|NN replace categorical dimensional approach|NN base severity|NN dysfunctional personality|NN trait|NN domain|NN
clinician|NN object characterize new diagnostic system|NN unwieldy conglomeration|NN disparate model|NN happily coexist limit usefulness|NN clinical practice|NN general move|NN dimensional personality|NN view|NN personality|NN disorder|NN maintain reintroduction|NN Narcissistic personality disorder|Disease
world|NN health|NN organization|NN international statistical classification|NN disease|NN relate health|NN problem|NN edition|NN list|NN Narcissistic personality disorder|Disease specific personality|NN disorder|NN
requirement|NN icd-10|NN diagnosis|NN specific personality|NN disorder|NN satisfy set|NN general personality|NN disorder|NN criteria|NN
dsm-5|NN regard Narcissistic personality disorder|Disease homogeneous syndrome|NN evidence|NN variation|NN expression|NN paper|NN major presentation|NN narcissism|NN typically suggest overt grandiose subtype|NN characterize arrogance|NN boldness|NN covert vulnerable subtype|NN characterize defensiveness|NN hypersensitivity|NN narcissistic express behavior|NN exploitative act|NN lack|NN empathy|NN intense envy|NN aggression|NN exhibitionism|NN
psychiatrist|NN glen|NP gabbard|NP describe subtype|NN refer oblivious subtype|NN grandiose arrogant thick-skine
subtype|NN narcissistic vulnerability|NN entail conscious level|NN helplessness|NN emptiness|NN low self-esteem|NN shame|NN express behavior|NN socially avoidant situation|NN self-presentation|NN possible withdraw approval|NN needexpect met
describe subtype|NN refer hypervigilant subtype|NN easily hurt oversensitive asham
addition|NN high-function presentation|NN impairment|NN area|NN life|NN severe expression|NN disorder|NN typically difficulty|NN suggest
theodore|NP millon|NP suggest subtype|NN narcissism|NN pure variant|NN subtype|NN subtype|NN recognize dsm|NP icd|NP
description|NN personality|NN trait|NN narcissist|NN antisocial feature|NN
conscience|NN unscrupulous immoral disloyal fraudulent deceptive arrogant exploitative con-artist|NN charlatan|NN dominate contemptuous vindictive
narcissist|NN histrionic feature|NN
sexually seductive entice beguil tantalize glib clever disincline real intimacy|NN indulge hedonistic desire|NN pathological ly|NN swindle|NN
tend affair|NN exotic partner|NN
narcissist|NN negativistic|NN avoidant|NN feature|NN counteract cancel deep feel|NN inferiority|NN lack|NN self-esteem|NN offset deficit|NN create illusion|NN superior exceptional admirable noteworthy self-worth|NN result|NN
narcissist variant|NN pure pattern|NN feel privileg empower virtue|NN special childhood|NN status|NN entitle faade|NN bear little relation|NN reality|NN seek good life|NN upwardly mobile cultivate special status|NN advantage|NN association|NN
normal absent trait|NN severe concern empathetic entitle deficient reciprocity|NN bold environment|NN self-confident competitive seek high target|NN feel unique talent|NN leadership|NN position|NN expect recognition|NN
possible additional category|NN cite current theory|NN millon|NN include description|NN personality|NN trait|NN fanatic|NN paranoid feature|NN delusion|NN irrational flimsy pretentious expensive supercilious contempt|NN arrogance|NN lost pride|NN extravagant claim|NN fantasy|NN
reclassify paranoid personality|NN disorder|NN
narcissist mix|NN initial subtype|NN avoidant|NN responsibility|NN blame|NN shift idiosyncratic proud minor quirk|NN achievement|NN sensitive rejection|NN avolitive|NN introspective prone fantastic inner world|NN replace social life|NN
narcissist|NN antisocial sadistic paranoid feature|NN
fearless remorseless calculate ruthless inhumane callous brutal rancorous aggressive bite merciless vicious cruel spiteful hateful jealous anticipate betrayal|NN seek punishment|NN desire|NN revenge|NN isolate potentially suicidal homicidal
titshaw suggest subtype|NN Narcissistic personality disorder|Disease officially recognize edition|NN dsm|NP icd|NP
citation|NN need description|NN description|NN pure mainly Narcissistic personality disorder|Disease characteristics|NN
narcissistic feature|NN describe dsm|NP icd|NP lack feature|NN personality|NN disorder|NN
attention|NN narcissist|NN histrionic hpd feature|NN
display traditional Narcissistic personality disorder|Disease characteristics|NN describe icd|NP dsm|NP histrionic feature|NN due fact|NN think superior therefore attention|NN attention|NN go way|NN capture attention|NN people|NN possible
rule|NN antisocial aspd feature|NN
type|NN narcissist|NN think superior follow rule|NN people|NN therefore show behavior|NN include icd|NP personality|NN disorder|NN behavior|NN include dsm|NP antisocial personality|NN disorder|NN
Narcissistic personality disorder|Disease high rate|NN comorbidity|NN mental disorder|NN individual|NN Narcissistic personality disorder|Disease prone bout|NN depression|NN meet|NN criteria|NN depressive|NN disorder|NN addition|NN Narcissistic personality disorder|Disease associate bipolar disorder|NN anorexia|NN substance|NN use|NN disorder|NN especially cocaine|NN far personality|NN disorder|NN Narcissistic personality disorder|Disease associate histrionic borderline|NN antisocial paranoid personality|NN disorder|NN treatment|NN
Narcissistic personality disorder|Disease rarely primary reason|NN people|NN seek mental health|NN treatment|NN
people|NN Narcissistic personality disorder|Disease enter treatment|NN typically prompt life|NN difficulty|NN seek relief|NN disorder|NN major depressive|NN disorder|NN substance|NN use|NN disorder|NN bipolar disorder|NN eate|NN disorder|NN partly individual|NN Narcissistic personality disorder|Disease generally poor insight|NN fail recognize perception|NN behavior|NN inappropriate problematic due|NN positive self-image|NN
treatment|NN Narcissistic personality disorder|Disease center psychotherapy|NN heinz|NP otto|NP kernberg|NP challeng conventional wisdom|NN time|NN outline clinical strategy|NN use psychoanalytic psychotherapy|NN client|NN Narcissistic personality disorder|Disease claim effective treate disorder|NN
contemporary treatment|NN modality|NN commonly involve metacognitive|NN schema-focuse|NN therapy|NN
improvement|NN observe treatment|NN symptom|NN relate comorbid disorder|NN psychopharmaceutical|NN 2016|NN elsa|NP psychologist|NN harvard|NP medical school|NN alliance|NN build|NN engage patient|NN sense|NN agency|NN reflective ability|NN essential change|NN pathological narcissism|NN
therapy|NN beneficial partner|NN participate
medication|NN indicate treate Narcissistic personality disorder|Disease use treat mental condition|NN symptom|NN associate depression|NN anxiety|NN impulsiveness|NN present
effectiveness|NN psychotherapeutic pharmacological intervention|NN treatment|NN Narcissistic personality disorder|Disease systematically empirically investigate
clinical practice|NN guideline|NN disorder|NN create current treatment|NN recommendation|NN largely base theoretical psychodynamic model|NN Narcissistic personality disorder|Disease experience|NN clinician|NN afflict individual|NN clinical set|NN
presence|NN Narcissistic personality disorder|Disease patient|NN undergo psychotherapy|NN treatment|NN mental disorder|NN associate slower treatment|NN progress|NN higher dropout|NN rate|NN epidemiology|NN
lifetime|NN prevalence|NN Narcissistic personality disorder|Disease estimate general population|NN clinical population|NN systematic review|NN found prevalence|NN Narcissistic personality disorder|Disease community|NN sample|NN small gender|NN difference|NN men|NN slightly higher incidence|NN women|NN
meta-analysis|NN look gender|NN difference|NN Narcissistic personality disorder|Disease recently debate|NN perceive increase|NN prevalence|NN Narcissistic personality disorder|Disease younger generation|NN women|NN
author|NN found reflect data|NN prevalence|NN remain relatively stable gender|NN year|NN data|NN disorder|NN collect history|NN
use|NN term|NN narcissism|NN describe excessive vanity|NN self-centeredness|NN predate year|NN modern medical classification|NN Narcissistic personality disorder|Disease
condition|NN name narcissus|NP mythological greek youth|NN became infatuate reflection|NN lake|NN
realize reflection|NN dy grief|NN fallen love|NN exist
term|NN narcissistic personality|NN structure|NN introduce otto|NP friedmann|NP Narcissistic personality disorder|Disease subsequently propose heinz|NP early freudianism|NN
sigmund|NP freud|NP comment adult|NN neurotics|NN sense|NN omnipotence|NN belief|NN frank acknowledgment|NN relic|NN old Narcissistic personality disorder|Disease infancy|NN similarly conclude detect element|NN Narcissistic personality disorder|Disease form|NN disorder|NN
justify assume Narcissistic personality disorder|Disease essential infantile nature|NN development|NN procee|NN sacrifice social consideration|NN
edmund|NP bergler consider Narcissistic personality disorder|Disease normal child|NN reactivate later life|NN gamble|NN otto|NP fenichel|NP state react later life|NN narcissistic hurt|NN denial|NN similar regression|NN Narcissistic personality disorder|Disease childhood|NN take place|NN object|NN relation|NN
freud|NP saw Narcissistic personality disorder|Disease obstacle|NN psychoanalysis|NN half|NN century|NN object|NN relation|NN theory|NN united|NP states|NP british kleinian set|NN Narcissistic personality disorder|Disease defence|NN mechanism|NN offer potential access|NN therapy|NN approach|NN built heinz|NP view|NN narcissistic Narcissistic personality disorder|Disease aspect|NN normal development|NN contrast|NN consideration|NN grandiosity|NN pathological development|NN distortion|NN society|NN culture|NN
popular culture|NN Narcissistic personality disorder|Disease call Narcissistic personality disorder|Disease fiction|NN
article|NN victorian web|NN argue rosamond|NP vincy george|NP eliots|NP middlemarch|NP full-blown narcissist|NN define dsm|NP
film|NN die nicole|NP character|NN want appear television|NN cost|NN even involve murder husband|NN
psychiatric assessment|NN character|NN note seen prototypical narcissistic person|NN rater|NN average|NN satisfy criteria|NN Narcissistic personality disorder|Disease evaluate personality|NN disorder|NN receive diagnosis|NN Narcissistic personality disorder|Disease
example|NN popular fiction|NN include television|NN character|NN adam|NP portray adam|NP workaholics|NN dennis|NP reynolds|NP portray glenn|NP alway sunny philadelphia|NP
norwegian study|NN conclude narcissism|NN conceive personality|NN dimension|NN pertinent whole range|NN pd|NN distinct diagnostic category|NN sarabia examine past literature|NN disorder|NN conclude Narcissistic personality disorder|Disease show inconsistency|NN consideration|NN trait|NN domain|NN need further research|NN strongly beneficial field|NN see
brian|NP blackwell|NP case|NN study|NN hubris|NN abuse|NN leadership|NN parent|NN personality|NN inventory|NN rage|NN narcissistic injury|NN supply|NN complex true self|NN false self|NN
