free encyclopedia|NN jump|NN navigation|NN jump|NN search|NN Onychomycosis|Disease name|NN Onychomycosis|Disease Onychomycosis|Disease toenail|NN affect Onychomycosis|Disease specialty infectious disease|NN symptom|NN white yellow nail|NN discoloration|NN thicken|NN nail|NN complication|NN lower leg|NN usual onset|NN older male|NN cause|NN infection|NN risk|NN factor|NN athlete|NN foot|NN nail|NN disease|NN exposure|NN condition|NN peripheral vascular disease|NN poor immune function|NN diagnostic method|NN base appearance|NN confirm laboratory|NN test|NN differential diagnosis|NN chronic dermatitis|NN chronic paronychia|NN nail|NN trauma|NN treatment|NN none medication|NN trim nail|NN ciclopirox|NN recur frequency|NN adult|NN
Onychomycosis|Disease known Onychomycosis|Disease fungal infection|NN nail|NN symptom|NN include white yellow nail|NN discoloration|NN thicken|NN nail|NN separation|NN nail|NN nail|NN bed|NN fingernail|NN affect common toenail|NN affect complication|NN include lower leg|NN number|NN different type|NN fungus|NN cause Onychomycosis|Disease dermatophyte|NN risk|NN factor|NN include athlete|NN foot|NN nail|NN disease|NN exposure|NN condition|NN peripheral vascular disease|NN poor immune function|NN diagnosis|NN generally suspect base appearance|NN confirm laboratory|NN test|NN
Onychomycosis|Disease necessarily require treatment|NN antifungal medication|NN taken mouth|NN appear effective associate liver|NN problem|NN affect nail|NN treatment|NN appear useful ciclopirox-contain nail|NN polish|NN work well condition|NN return|NN case|NN treatment|NN use old shoe|NN treatment|NN decrease risk|NN recurrence|NN
occur percent|NN adult|NN population|NN older people|NN frequently affect male|NN affect female|NN Onychomycosis|Disease represent nail|NN disease|NN determine result|NN fungal infection|NN georg|NP content|NN
sign|NN symptom|NN cause|NN risk|NN factor|NN diagnosis|NN classification|NN differential diagnosis|NN treatment|NN cost|NN united|NP states|NP epidemiology|NN research|NN reference|NN external link|NN
sign|NN symptom|NN case|NN fungal infection|NN big toe|NN advance fungal infection|NN big toe|NN
common symptom|NN fungal nail|NN infection|NN nail|NN becom thicken discolour white black yellow|NN green|NN
infection|NN progress nail|NN become brittle piece|NN break come toe|NN finger|NN completely
left untreate skin|NN underneath nail|NN become inflam painful
white yellow patche|NN nailb|NN scaly skin|NN nail|NN foul smell|NN usually pain|NN bodily symptom|NN disease|NN severe people|NN Onychomycosis|Disease experience significant psychosocial problem|NN due appearance|NN nail|NN particularly finger|NN alway visible toenail|NN affect fungus-free skin|NN lesion|NN sometime form|NN result|NN fungus|NN infection|NN part|NN body|NN
take form|NN rash|NN itch|NN area|NN body|NN infect fungus|NN
thought allergic reaction|NN fungus|NN
causative pathogen|NN Onychomycosis|Disease fungus|NN kingdom|NN include candida|NP yeast|NN nondermatophytic|NN fungy|NN commonly responsible Onychomycosis|Disease temperate western country|NN candida|NP nondermatophytic|NP molds|NP frequently involve tropics|NN subtropics|NN hot humid climate|NN
common involve Onychomycosis|Disease
dermatophyte|NN involve
common outdate name|NN report medical laboratory|NN trichophyton mentagrophyte t|NP
name|NN t|NP mentagrophytes|NP restrict agent|NN skin|NN infection|NN mouse|NN fungus|NN transmit mice|NN dander|NN human|NN generally infect skin|NN nail|NN
causative pathogen|NN include candida|NP mold|NN particular member|NN mold genus|NN name|NN recently change scopulariopsis|NN aspergillus|NN
candida|NP specy|NN mainly cause fingernail|NN Onychomycosis|Disease people|NN hand|NN submerge water|NN
mainly affect people|NN tropics|NN persist later move area|NN temperate climate|NN
mold|NN commonly affect people|NN older year|NN presence|NN nail|NN reflect slight weaken|NN nail|NN ability|NN defend fungal invasion|NN
risk|NN factor|NN
common risk|NN factor|NN Onychomycosis|Disease due|NN diminish blood|NN circulation|NN longer exposure|NN fungy|NN nail|NN grow slowly thicken increase susceptibility|NN infection|NN
nail|NN fungus|NN tend affect men|NN women|NN associate family|NN history|NN infection|NN
risk|NN factor|NN include perspire heavily humid moist environment|NN psoriasis|NN wear sock|NN shoe|NN hinder ventilation|NN absorb perspiration|NN go barefoot damp public place|NN swim|NN pool|NN gym|NN shower|NN room|NN athlete|NN foot|NN minor skin|NN nail|NN injury|NN damage nail|NN infection|NN diabete|NN circulation|NN problem|NN lead lower peripheral temperature|NN hand|NN feet|NN weaken immune system|NN diagnosis|NN
diagnosis|NN generally suspect base appearance|NN confirm laboratory|NN test main test|NN potassium|NN hydroxide|NN smear|NN culture|NN histology|NN examination|NN polymerase|NN chain|NN reaction|NN sample|NN examine generally nail|NN scrape|NN clip|NN far nail|NN possible
nail|NN plate|NN biopsy|NN periodic acid-schiff stain|NN appear useful culture|NN direct koh|NN examination|NN reliably identify mold sample|NN necessary classification|NN
classic type|NN Onychomycosis|Disease
subungual Onychomycosis|Disease common form|NN Onychomycosis|Disease usually cause rubrum|NN invade nail|NN bed|NN underside|NN nail|NN plate|NN
white superficial Onychomycosis|Disease wso|NN cause fungal invasion|NN superficial layer|NN nail|NN plate|NN form white island|NN plate|NN
account percent|NN Onychomycosis|Disease case|NN
case|NN misdiagnosis|NN keratin|NN fungus|NN reaction|NN nail|NN polish|NN cause nail|NN chalky white appearance|NN
laboratory|NN test|NN perform confirm subungual Onychomycosis|Disease fungal penetration|NN newly form nail|NN plate|NN proximal nail|NN fold|NN
common form|NN Onychomycosis|Disease healthy people|NN found commonly patient|NN immunocompromise candidal Onychomycosis|Disease candida|NP specy|NN invasion|NN fingernail|NN usually occure person|NN frequently immerse hand|NN water|NN
normally require prior damage|NN nail|NN infection|NN trauma|NN
differential diagnosis|NN
case|NN suspect nail|NN fungus|NN actually fungal infection|NN nail|NN deformity|NN
avoid nail|NN psoriasis|NN lichen|NN contact|NN dermatitis|NN nail|NN bed|NN melanoma|NN trauma|NN yellow nail|NN syndrome|NN laboratory|NN confirmation|NN necessary
condition|NN appear similar Onychomycosis|Disease include psoriasis|NN normal age yellow nail|NN syndrome|NN chronic paronychia|NN treatment|NN person|NN foot|NN fungal nail|NN infection|NN week|NN course|NN oral medication|NN
note band|NN healthy pink nail|NN growth|NN remain infect nail|NN
treatment|NN antifungal medication|NN topically mouth|NN avoid use|NN therapy|NN mouth|NN eg person|NN confirm infection|NN recommend possible side|NN effect|NN treatment|NN
topical agent|NN include nail|NN paint|NN topical treatment|NN need apply daily prolong period|NN year|NN topical amorolfine|NN apply weekly topical ciclopirox|NN result|NN cure|NN case|NN effective use terbinafine|NN appear better agent|NN alone
medication taken mouth|NN include effective itraconazole|NN effective fluconazole effective share characteristics|NN enhance effectiveness|NN prompt|NN penetration|NN nail|NN nail|NN bed|NN persistence|NN nail|NN month|NN discontinuation|NN therapy|NN mouth|NN recommend due side|NN effect|NN oral terbinafine|NN better tolerate itraconazole superficial white|NN Onychomycosis|Disease systemic topical antifungal|NN therapy|NN advise
chemical|NN surgical debridement|NN affect nail|NN appear improve outcome|NN
evidence|NN laser|NN treatment|NN unclear evidence|NN low quality|NN vary type|NN laser|NN
tea|NN tree|NN oil|NN recommend treatment|NN effective cost|NN united|NP states|NP
study|NN cost|NN unit state|NN test|NN periodic acidschiff|NN stain|NN
even cheaper koh|NN test|NN use test|NN use koh test|NN negative good chance|NN true false negative|NN koh test|NN
terbinafine treatment|NN cost|NN additional liver|NN function|NN test|NN
conclusion|NN author|NN say relatively benign adverse effect|NN profile|NN liver|NN damage|NN rare make sense|NN dermatologist|NN prescribe treatment|NN test|NN
option|NN prescribe treatment|NN potassium|NN hydroxide|NN test|NN positive give false negative|NN case|NN fungal infection|NN
hand|NN price|NN topical non-oral|NN treatment|NN efinaconazole|NP 2307 nail|NN test|NN recommend prescribe
follow effective treatment|NN recurrence|NN common nail|NN fungus|NN painful cause|NN permanent damage|NN nail|NN
lead serious infection|NN immune system|NN suppress medication|NN diabete|NN condition|NN
risk|NN serious people|NN diabete|NN immune system|NN weaken leukemia|NN aid|NN medication|NN organ|NN transplant|NN
vascular nerve|NN impairment|NN risk|NN cellulitis|NN potentially serious bacterial infection|NN relatively minor injury|NN feet|NN nail|NN fungal infection|NN lead serious complication|NN infection|NN bone|NN rare complication|NN epidemiology|NN
survey|NN disease|NN foot|NN european country|NN found Onychomycosis|Disease frequent fungal foot|NN infection|NN estimate prevalence|NN prevalence|NN observe increase age|NN
canada|NP prevalence|NN estimate Onychomycosis|Disease affect approximately diabetics|NN frequent people|NN suffer psoriasis|NN
term|NN greek
onyx|NN nail|NN
fungus|NN suffix|NN
functional disease|NN
research|NN suggest fungy|NN sensitive heat typically c|NP f|NP
basis|NN laser|NN treatment|NN try heat nail|NN bed|NN temperature|NN order|NN disrupt fungal growth|NN research|NN laser|NN treatment|NN seem promise ongo development|NN therapy|NN use laser|NN led|NN light|NN activate eradicate fungy|NN
