free encyclopedia|NN jump|NN navigation|NN jump|NN search|NN Ovarian cancer|Disease ovarian tumour|NN micrograph|NN mucinous ovarian carcinoma|NN stain
oncology|NN symptom|NN early vague later bloat pelvic pain|NN abdominal swell loss|NN appetite|NN usual onset|NN usual age|NN diagnosis|NN year|NN old type|NN carcinoma|NN germ|NN cell|NN tumor|NN sex|NN cord|NN stromal tumor|NN risk|NN factor|NN children|NN hormone|NN therapy|NN menopause|NN fertility|NN medication|NN obesity|NN genetics|NN diagnostic method|NN tissue|NN biopsy|NN treatment|NN surgery|NN radiation|NN therapy|NN chemotherapy|NN survival|NN rate|NN frequency|NN death|NN
Ovarian cancer|Disease cancer|NN form|NN ovary|NN result abnormal cell|NN ability|NN invade spread part|NN body|NN process|NN begin vague symptom|NN symptom|NN become noticeable cancer|NN progress symptom|NN include bloat pelvic pain|NN abdominal swell|NN loss|NN appetite|NN common area|NN cancer|NN spread include line|NN abdomen|NN lymph|NN node|NN lung|NN liver|NN
risk|NN Ovarian cancer|Disease increase|NN women|NN ovulate lifetime|NN
include children|NN begin ovulation|NN younger age|NN reach menopause|NN older age|NN risk|NN factor|NN include hormone|NN therapy|NN menopause|NN fertility|NN medication|NN obesity|NN factor|NN decrease|NN risk|NN include hormonal birth|NN control|NN tubal ligation|NN breast|NN feed|NN case|NN relate inherit genetic risk|NN women|NN mutation|NN gene|NN chance|NN develop disease|NN carcinoma|NN common type|NN Ovarian cancer|Disease comprise case|NN main subtype|NN ovarian carcinoma|NN high-grade serous|NN carcinoma|NN hgsc|NN common tumor|NN believe start cell|NN cover ovary|NN form fallopian tube|NN common type|NN Ovarian cancer|Disease include germ|NN cell|NN sex|NN cord|NN stromal diagnosis|NN Ovarian cancer|Disease confirm biopsy|NN tissue|NN usually remove surgery|NN
screen|NN recommend women|NN average risk|NN evidence|NN support reduction|NN death|NN high rate|NN false positive test|NN lead surgery|NN accompany risk|NN high risk|NN ovary|NN remove preventive measure|NN caught treate early stage|NN Ovarian cancer|Disease curable treatment|NN usually include combination|NN surgery|NN radiation|NN therapy|NN chemotherapy|NN outcome|NN depend extent|NN disease|NN subtype|NN cancer|NN present|NN medical condition|NN overal five-year survival|NN rate|NN united|NP states|NP outcome|NN worse develop world|NN
new case|NN occure approximately women|NN present women|NN result death|NN worldwide women|NN seventh-most common cancer|NN eighth-most common cause|NN death|NN cancer|NN typical age|NN diagnosis|NN death|NN Ovarian cancer|Disease common north|NP america|NP europe|NP africa|NP asia|NP content|NN
sign|NN symptom|NN early symptom|NN later symptom|NN children|NN risk|NN factor|NN genetics|NN environmental factor|NN protective factor|NN diagnosis|NN examination|NN pathology|NN screen|NN prevention|NN management|NN surgery|NN radiation|NN therapy|NN therapy|NN follow-up|NN care|NN care|NN factor|NN survival|NN rate|NN rate|NN epidemiology|NN united|NP states|NP united|NP kingdom|NP older women|NN pregnancy|NN animal|NN research|NN screen|NN research|NN pharmacology|NN radiation|NN clinical trial|NN reference|NN further read|NN external link|NN
sign|NN symptom|NN early symptom|NN site|NN Ovarian cancer|Disease
early sign|NN symptom|NN Ovarian cancer|Disease absent subtle
case|NN symptom|NN exist month|NN recognize diagnose symptom|NN misdiagnose irritable bowel|NN syndrome|NN early stage|NN Ovarian cancer|Disease tend painless
symptom|NN vary base subtype|NN low malignant potential|NN known borderline|NN cause increase|NN ca125 level|NN identifiable ultrasound|NN
typical symptom|NN lmp tumor|NN include abdominal distension|NN pelvic pain|NN
particularly large mass|NN tend benign borderline|NN
typical symptom|NN Ovarian cancer|Disease include bloat|NN abdominal pelvic pain|NN discomfort|NN back|NN pain|NN irregular menstruation|NN postmenopausal|NN vaginal bleed pain|NN bleed|NN sexual intercourse|NN loss|NN appetite|NN fatigue|NN indigestion|NN heartburn|NN constipation|NN nausea|NN feel|NN full possibly urinary symptom|NN frequent urination|NN urgent urination|NN later symptom|NN
grow mass|NN cause pain|NN ovarian torsion|NN develop
symptom|NN cause mass|NN press abdominopelvic|NN organ|NN metastase|NN symptom|NN start occur severely usual especially significant history|NN symptom|NN Ovarian cancer|Disease consider cause sister|NP mary|NP joseph|NP nodule|NN rarely cause grow teratoma syndrome|NN peritoneal experience|NN abnormal vaginal bleed|NN menopause|NN case|NN
common symptom|NN include abdominal pain|NN adnexal mass|NN children|NN
adolescent|NN children|NN ovarian tumor symptom|NN include severe abdominal pain|NN irritation|NN peritoneum|NN bleed symptom|NN sex|NN produce|NN hormone|NN affect development|NN secondary sex|NN characteristics|NN
sex|NN tumor|NN prepubertal children|NN manifest early puberty|NN abdominal pain|NN distension|NN common
adolescent|NN sex|NN experience
cancer|NN become advance cause accumulation|NN fluid|NN abdomen|NN
malignancy|NN diagnose time|NN cause ascite|NN typically diagnose shortly thereafter advance cancer|NN cause abdominal mass|NN lymph|NN node|NN mass|NN pleural effusion|NN risk|NN factor|NN
Ovarian cancer|Disease relate amount|NN time|NN spent
children|NN risk|NN factor|NN Ovarian cancer|Disease likely ovulation|NN suppress pregnancy|NN
ovulation|NN cell|NN constantly stimulate divide cycle|NN continue
therefore people|NN borne children|NN twice risk|NN Ovarian cancer|Disease
longer period|NN ovulation|NN cause early menstruation|NN late menopause|NN risk|NN factor|NN obesity|NN hormone|NN replacement|NN therapy|NN raise risk|NN
risk|NN develop Ovarian cancer|Disease women|NN menstrual cycle|NN menstrual cycle|NN breast|NN feed|NN take oral contraceptive|NN multiple pregnancy|NN pregnancy|NN early age|NN
risk|NN develop Ovarian cancer|Disease reduce women|NN tubal ligation|NN colloquially known tube|NN ty ovary|NN remove hysterectomy|NN operation|NN uterus|NN sometime cervix|NN remove age|NN risk|NN factor|NN
use|NN fertility|NN medication|NN contribute borderline|NN ovarian tumor|NN formation|NN link|NN dispute difficult study|NN fertility|NN drug|NN associate higher risk|NN borderline|NN treate infertility|NN remain higher risk|NN epithelial Ovarian cancer|Disease successfully treate infertility|NN subsequently give birth|NN higher risk|NN
due shed|NN precancerous cell|NN pregnancy|NN cause|NN remain unclear risk|NN factor|NN instead infertility|NN treatment|NN
condition|NN ovary|NN syndrome|NN endometriosis|NN associate Ovarian cancer|Disease link|NN completely confirm hormone|NN replacement|NN therapy|NN hrt|NN likely increase|NN risk|NN Ovarian cancer|Disease
association|NN confirm large-scale study|NN notable study|NN women|NN study|NN support link|NN
hrt|NN combine estrogen|NN progesterone|NN increase contemporaneous risk|NN use year|NN risk|NN return|NN normal cessation|NN therapy|NN hrt|NN progestin increase|NN risk|NN endometrioid|NN serous|NN lower risk|NN tumor|NN
higher dose|NN increase|NN risk|NN risk|NN factor|NN Ovarian cancer|Disease pain|NN menstruation|NN
associate clear-cel|NN endometrioid|NN subtype|NN low-grade stage|NN tumor grade|NN lower mortality|NN
menopause|NN obesity|NN increase person|NN risk|NN Ovarian cancer|Disease risk|NN present menopause|NN
risk|NN relevant obese use hrt|NN
similar association|NN Ovarian cancer|Disease appear taller people|NN genetics|NN further information|NN breast|NN Ovarian cancer|Disease syndrome|NN people|NN ovarian breast|NN cancer|NN pedigree|NN chart|NN family|NN
family|NN history|NN Ovarian cancer|Disease risk|NN factor|NN Ovarian cancer|Disease
people|NN hereditary nonpolyposis colon|NN cancer|NN lynch|NP syndrome|NN brca-1|NN genetic abnormality|NN increase risk|NN
major genetic risk|NN factor|NN Ovarian cancer|Disease mutation|NN brca1|NN dna|NN mismatch|NN repair|NN gene|NN present Ovarian cancer|Disease case|NN
allele|NN need mutate place person|NN high risk|NN
gene|NN inherit maternal paternal line|NN variable penetrance|NN mutation|NN gene|NN usually associate increase risk|NN breast|NN cancer|NN carry substantial lifetime|NN risk|NN Ovarian cancer|Disease risk|NN peak|NN person|NN
lowest risk|NN cite highest mutation|NN brca1|NP lifetime|NN risk|NN develop Ovarian cancer|Disease mutation|NN brca2|NN risky brca1|NN lifetime|NN risk|NN lowest risk|NN cite highest risk|NN cite average brca-associate|NN cancer|NN develop year|NN sporadic counterpart|NN people|NN inherit mutation|NN copy|NN gene|NN need mutation|NN start process|NN carcinogenesis|NN people|NN normal gene|NN need acquire mutation|NN
united|NP states|NP women|NN first-degree relative|NN Ovarian cancer|Disease eventually get Ovarian cancer|Disease place affect family|NN member|NN triple|NN risk|NN women|NN unaffect family|NN member|NN
women|NN relative|NN Ovarian cancer|Disease eventually get Ovarian cancer|Disease general|NN Ovarian cancer|Disease case|NN genetic cause|NN mutation|NN associate high-grade serous|NN epithelial Ovarian cancer|Disease
strong family|NN history|NN endometrial cancer|NN colon|NN cancer|NN gastrointestinal cancer|NN indicate presence|NN syndrome|NN known hereditary colorectal cancer|NN known lynch|NP syndrome|NN confer higher risk|NN develop number|NN cancer|NN Ovarian cancer|Disease
lynch|NP syndrome|NN cause mutation|NN mismatch|NN repair|NN gene|NN mlh1 mlh6|NN risk|NN Ovarian cancer|Disease individual|NN lynch|NP syndrome|NN percent|NN people|NN icelandic descent|NN european jewish jewish descent|NN hungarian descent|NN higher risk|NN epithelial Ovarian cancer|Disease receptor|NN beta|NN gene|NN seem key|NN pathogenesis|NN response|NN therapy|NN gene|NN associate Ovarian cancer|Disease brip1 msh6 cdh1 chek2|NN associate Ovarian cancer|Disease
rare genetic disorder|NN associate specific subtype|NN Ovarian cancer|Disease
syndrome|NN rare genetic disorder|NN predispose people|NN sex|NN cord|NN tumour|NN annular tubule|NN ollier|NP disease|NN syndrome|NN associate cell|NN children|NN associate tumor|NN
associate basal cell|NN carcinoma|NN syndrome|NN environmental factor|NN
nation|NN exception|NN japan|NP high rate|NN epithelial Ovarian cancer|Disease due diet|NN country|NN
caucasian 3040|NN higher risk|NN Ovarian cancer|Disease compare black hispanic people|NN likely due|NN socioeconomic factor|NN white women|NN tend children|NN different rate|NN gynecologic surgery|NN affect risk|NN Ovarian cancer|Disease
cohort|NN study|NN found correlation|NN dairy|NN consumption|NN Ovarian cancer|Disease case-control study|NN show correlation|NN
mix evidence|NN effect|NN red meat|NN process meat|NN Ovarian cancer|Disease
evidence|NN suggest talc|NN pesticide|NN herbicide|NN increase risk|NN Ovarian cancer|Disease american cancer|NN society|NN note|NN study|NN able accurately link|NN single chemical|NN environment|NN human diet|NN directly mutation|NN cause Ovarian cancer|Disease
alcohol|NN consumption|NN appear relate Ovarian cancer|Disease factor|NN investigate smoke low level|NN vitamin|NN blood|NN presence|NN inclusion|NN ovarian cyst|NN infection|NN human papilloma virus|NN cause|NN case|NN cervical cancer|NN disproven risk|NN factor|NN Ovarian cancer|Disease carcinogenicity|NN perineal talc|NN controversial act irritant|NN travel reproductive tract|NN ovary|NN study|NN show use|NN perineal talc|NN increase risk|NN Ovarian cancer|Disease use talc|NN create greater risk|NN use|NN talc|NN elsewhere body|NN unrelate Ovarian cancer|Disease sit regularly prolong period|NN associate higher mortality|NN epithelial Ovarian cancer|Disease
risk|NN negate regular exercise|NN lower
increase age|NN risk|NN factor|NN epithelial Ovarian cancer|Disease mutation|NN cell|NN accumulate eventually cause|NN cancer|NN
slightly lower risk|NN
smoke|NN tobacco|NN associate higher risk|NN Ovarian cancer|Disease smoke|NN cessation|NN risk|NN eventually return normal
diet|NN high animal|NN fat|NN associate Ovarian cancer|Disease connection|NN unclear
diet|NN seem play small role|NN Ovarian cancer|Disease risk|NN higher level|NN c-reactive protein|NN associate higher risk|NN develop Ovarian cancer|Disease protective factor|NN
suppression|NN ovulation|NN otherwise cause damage|NN ovarian epithelium|NN consequently inflammation|NN generally protective
effect|NN achieve children|NN take combine oral contraceptive|NN breast|NN feed protective factor|NN longer period|NN breastfeed|NN correlate|NN larger decrease|NN risk|NN Ovarian cancer|Disease birth|NN decrease risk|NN Ovarian cancer|Disease effect|NN seen birth|NN
combine oral contraceptive|NN reduce risk|NN Ovarian cancer|Disease protective effect|NN combine oral contraceptive|NN last year|NN discontinue regular use|NN aspirin|NN paracetamol|NN associate lower risk|NN Ovarian cancer|Disease nsaids|NP seem similar protective effect|NN
ligation|NN protective carcinogen|NN unable reach ovary|NN fimbriae|NN vagina|NN uterus|NN fallopian tube|NN ligation|NN protective women|NN brca1 mutation|NN brca2 mutation|NN reduce risk|NN removal|NN fallopian tube|NN ovary|NN bilateral dramatically reduce risk|NN Ovarian cancer|Disease breast|NN cancer|NN well topic|NN research|NN link|NN hysterectomy|NN lower Ovarian cancer|Disease risk|NN controversial
reason|NN hysterectomy|NN protective elucidate
diet|NN include large amount|NN carotene|NN vitamin|NN low amount|NN fatspecifically|NN diet|NN non-starchy vegetable|NN eg broccoly|NN onionsmay|NN protective research|NN ongo area|NN higher caffeine|NN intake|NN consumption|NN cup|NN tea|NN day|NN associate lower Ovarian cancer|Disease risk|NN smoke|NN tobacco|NN protective sex|NN pathophysiology mutation|NN found Ovarian cancer|Disease subtype|NN gene|NP mutate mutation|NN type|NN prevalence|NN amplification|NN point|NN mutation|NN clear cell|NN deletion|NN point|NN mutation|NN low-grade nonsense|NN mutation|NN high-grade brca2|NN mutation|NN high-grade amplification|NN amplification|NN high-grade serous|NN deletion|NN clear cell|NN mutation|NN somatic dynlrb1|NN mutation|NN amplificationoverexpression|NN low-grade serous|NN fm|NN csf-1|NP point|NN mutation|NN adult|NN cell|NN amplification|NN amplification|NN amplification|NN low-grade serous|NN amplification|NN point|NN mutation|NN amplification|NN point|NN mutation|NN amplification|NN deletion|NN point|NN mutation|NN high-grade serous|NN amplification|NN point|NN mutation|NN low-grade pik3c3 pi3k3|NN amplification|NN clear cell|NN clear cell|NN deletion|NN clear cell|NN deletion|NN point|NN mutation|NN
tp53|NN high-grade serous|NN
ri|NP mutation|NN
Ovarian cancer|Disease form|NN error|NN normal ovarian cell|NN growth|NN occur
usually cell|NN grow old get damage die new cell|NN take place|NN
cancer|NN start new cell|NN form|NN old damage cell|NN die
buildup|NN extra cell|NN form mass|NN tissue|NN call growth|NN tumor|NN
abnormal cancer|NN cell|NN genetic abnormality|NN cause grow excessively ovary|NN release egg|NN egg|NN follicle|NN burst|NN open become corpus|NN
structure|NN need repair divide cell|NN ovary|NN continuous ovulation|NN long time|NN mean repair|NN ovary|NN divide cell|NN acquire mutation|NN division|NN
overal common gene|NN mutation|NN Ovarian cancer|Disease occur brca1|NN
type|NN Ovarian cancer|Disease tend aggressive tend instability|NN gene|NN oncogene|NN notably kra tumor|NN notably common mutation|NN type|NN cancer|NN kra pten|NN type|NN cancer|NN aggressive type|NN different gene|NN mutate low-grade cancer|NN tend mutation|NN kra|NN cancer|NN grade|NN develop low malignant potential|NN tend mutation|NN type|NN cancer|NN tend develop precursor|NN lesion|NN type|NN cancer|NN develop serous tubal intraepithelial carcinoma|NN cancer|NN brca mutation|NN inevitably mutation|NN indicate removal|NN functional gene|NN important cancer|NN develop
high-grade serous|NN cancer|NN homologous recombination|NN dna|NN repair|NN dysfunctional notch|NN foxm1|NN pathway|NN
alway mutation|NN
mutation|NN high-grade serous carcinoma|NN hard characterize high degree|NN genomic instability|NN
essential homologous recombination|NN dna|NN repair|NN germline|NN mutation|NN gene|NN found people|NN Ovarian cancer|Disease common mutation|NN brca1|NN frameshift mutation|NN originate small found|NN population|NN ashkenazy jew|NN
rare mucinous|NN carcinoma|NN mutation|NN kra|NN amplification|NN known overal Ovarian cancer|Disease mutation|NN
carcinoma|NN develop tubal intraepithelial carcinoma|NN develop spontaneously ovarian tissue|NN
carcinoma|NN develop cortical inclusion|NN cyst|NN group|NN epithelial ovarian cell|NN stroma|NN diagnosis|NN examination|NN large Ovarian cancer|Disease seen ct|NN micrograph|NN carcinoma|NN type|NN Ovarian cancer|Disease diagnose peritoneal fluid|NN
diagnosis|NN Ovarian cancer|Disease start physical examination|NN pelvic examination|NN blood|NN test|NN ca-125|NN sometime marker|NN ultrasound|NN sometime rectovaginal examination|NN use help plan|NN surgery|NN diagnosis|NN confirm surgery|NN inspect abdominal cavity|NN take biopsy|NN tissue|NN sample|NN microscopic analysis|NN look|NN cancer|NN cell|NN abdominal fluid|NN
help determine ovarian mass|NN benign malignant
Ovarian cancer|Disease early stage|NN difficult diagnose symptom|NN nonspecific little use|NN diagnosis|NN result|NN rarely diagnose spread advance|NN later stage|NN additionally symptom|NN Ovarian cancer|Disease appear similar irritable bowel|NN syndrome|NN
patient|NN pregnancy|NN possibility|NN level|NN measure diagnosis|NN process|NN
serum|NN neuron-specific|NN lactate|NN dehydrogenase|NN measure young girl|NN adolescent|NN suspect ovarian tumor|NN younger patient|NN likely malignant germ|NN cell|NN
physical examination|NN pelvic examination|NN pelvic ultrasound|NN otherwise essential diagnosis|NN physical examination|NN reveal increase abdominal girth|NN ascite|NN fluid|NN abdominal cavity|NN pelvic examination|NN reveal ovarian abdominal mass|NN adnexal mass|NN significant find|NN indicate Ovarian cancer|Disease especially fix nodular irregular solid|NN bilateral mass|NN cause malignancy|NN benign cause|NN adnexal mass|NN ovarian follicular cyst|NN endometriosis|NN ectopic pregnancy|NN abscess|NN ovarian torsion|NN cyst|NN cystadenoma|NN diverticular|NN abscess|NN nerve|NN sheath|NN tumor|NN pelvic kidney|NN bladder|NN benign cystic mesothelioma|NN peritoneum peritoneal tuberculosis|NN cyst|NN
ovary felt sign|NN Ovarian cancer|Disease postmenopausal|NN women|NN
part|NN physical examination|NN suspect Ovarian cancer|Disease include breast|NN examination|NN digital rectal exam|NN
palpation|NP supraclavicular axillary inguinal lymph|NN node|NN reveal lymphadenopathy|NN indicative metastasis|NN
indicator|NN presence|NN pleural effusion|NN note
ovarian malignancy|NN include list|NN diagnostic possibility|NN limit number|NN laboratory|NN test|NN indicate
complete blood|NN count|NN serum|NN electrolyte|NN test|NN usually obtain Ovarian cancer|Disease present test|NN show high number|NN platelet|NN people|NN low blood|NN sodium|NN level|NN due chemical signal|NN secret tumor|NN positive test|NN inhibin|NP inhibin|NP b|NP indicate granulosa cell|NN tumor|NN
blood|NN test|NN marker|NN molecule|NN call useful differential diagnosis|NN follow|NN disease|NN show effective method|NN screen|NN Ovarian cancer|Disease due|NN unacceptable low sensitivity|NN specificity|NN level|NN people|NN uml|NN indicate Ovarian cancer|Disease elevation|NN ca-125|NN uml|NN people|NN
level|NN accurate early stage|NN Ovarian cancer|Disease fully stage|NN Ovarian cancer|Disease patient|NN normal ca-125|NN level|NN elevate benign non-cancerous condition|NN endometriosis|NN pregnancy|NN uterine fibroid|NN menstruation|NN ovarian cyst|NN systemic liver|NN disease|NN inflammatory bowel|NN disease|NN pelvic inflammatory disease|NN he4|NN candidate|NN Ovarian cancer|Disease test|NN extensively test
tumor|NN marker|NN Ovarian cancer|Disease include ca72-4 immunosuppressive acidic protein|NN mesothelin|NN acid|NN fibroblast|NN growth|NN factor|NN
use|NN blood|NN test|NN panel|NN help diagnosis|NN ova1 panel|NN include microglobulin transferrin|NN
ova1 people|NN postmenopausal|NN people|NN indicate high risk|NN cancer|NN different set|NN laboratory|NN test|NN use detect sex|NN
high level|NN testosterone|NN dehydroepiandrosterone|NN combine symptom|NN high level|NN inhibin|NN indicative scst|NN type|NN
current research|NN look way|NN consider tumor|NN marker|NN combination|NN indicator|NN disease|NN ie radiology|NN symptom|NN improve diagnostic accuracy|NN
challenge|NN approach|NN disparate prevalence|NN Ovarian cancer|Disease mean even test|NN high sensitivity|NN specificity|NN lead number|NN false positive result|NN turn|NN lead issue|NN perform surgical procedure|NN cancer|NN found
citation|NN need approache|NN develop Ovarian cancer|Disease
ct|NN scan|NN prefer assess extent|NN tumor|NN abdominopelvic cavity|NN magnetic resonance|NN image|NN use ct|NN scan|NN useful find cake|NN differentiate fluid|NN solid tumor|NN abdomen|NN especially low malignant potential|NN
detect smaller tumor|NN
sometime chest|NN x-ray|NN use detect metastase|NN chest|NN pleural effusion|NN
test|NN metastatic disease|NN infrequently use barium|NN enema|NN show rectosigmoid colon|NN involve disease|NN
emission|NN tomography|NN bone|NN scan|NN paracentesis|NN limit use|NN fact|NN cause metastase|NN form|NN needle|NN insertion|NN site|NN provide useful result|NN use case|NN pelvic mass|NN ascite|NN present physician|NN suspect Ovarian cancer|Disease perform endometrial biopsy|NN case|NN abnormal bleed|NN assess possibility|NN breast|NN malignancy|NN endometrial malignancy|NN respectively
ultrasonography|NN first-line image|NN study|NN perform adnexal mass|NN found
characteristics|NN adnexal mass|NN indicate ovarian malignancy|NN usually solid irregular multilocular|NN large typically feature|NN central vessel|NN irregular internal septation|NN definitive characteristics|NN radiographic study|NN
definitively diagnose Ovarian cancer|Disease surgical procedure|NN inspect abdomen|NN require
open procedure|NN laparotomy|NN incision|NN abdominal wall|NN keyhole|NN surgery|NN laparoscopy|NN
procedure|NN suspicious tissue|NN remove sent microscopic analysis|NN
usually include unilateral salpingo-oophorectomy|NN removal|NN single affect ovary|NN fallopian tube|NN
fluid|NN abdominal cavity|NN analyze cancerous cell|NN
cancer|NN found procedure|NN use determine extent|NN spread|NN form|NN tumor|NN stage|NN risk|NN score|NN
widely recognize method|NN estimate risk|NN malignant Ovarian cancer|Disease risk|NN malignancy|NN index|NN rmi|NP calculate base initial|NN rmi|NP score|NN generally felt indicate high risk|NN Ovarian cancer|Disease
rmi|NP calculate
rmi|NP ultrasound|NN score|NN menopausal score|NN level|NN
method|NN use determine ultrasound|NN score|NN menopausal score|NN resultant score|NN refer rmi|NP rmi|NP respectively method|NN use
feature|NN rmi|NP rmi|NP
ultrasound abnormality|NN
cyst|NN solid area|NN ascite|NN intra-abdominal metastase|NN
abnormality|NN abnormality|NN abnormality|NN
none abnormality|NN abnormality|NN
quantity|NN quantity|NN
method|NN quantify risk|NN Ovarian cancer|Disease risk|NN Ovarian cancer|Disease algorithm|NN roca|NN observe level|NN time|NN determine increase rapidly warrant ultrasound|NN risk|NN malignancy algorithm|NN use|NN level|NN he4 level|NN calculate risk|NN Ovarian cancer|Disease effective rmi|NP
iota model|NN use estimate probability|NN adnexal tumor|NN malignant include risk|NN model|NN simple rule|NN risk|NN calculation|NN assessment|NN different neoplasia|NN adnexa|NN model|NN use assess risk|NN malignancy|NN adnexal mass|NN base characteristics|NN risk|NN factor|NN
qcancer|NN algorithm|NN use predict likelihood|NN Ovarian cancer|Disease risk|NN factor|NN pathology|NN Ovarian cancer|Disease women|NN area|NN represent incidence|NN color|NN represent five-year relative survival|NN rate|NN
Ovarian cancer|Disease classify microscopic appearance|NN structure|NN histology|NN histopathology|NN
histology|NN dictate aspect|NN clinical treatment|NN management|NN prognosis|NN
gross pathology|NN Ovarian cancer|Disease similar regardless type|NN solid cystic mass|NN seer type|NN Ovarian cancer|Disease women|NN age|NN percent|NN Ovarian cancer|Disease women|NN age|NN percent|NN Ovarian cancer|Disease women|NN age|NN
subdivision|NN histology|NN 897 surface|NN tumor|NN adenocarcinoma|NN borderline|NN adenocarcinoma|NN underestimate short data|NN collection|NN interval|NN otherwise specify tumor|NN ovarian tumor|NN adenocarcinoma|NN otherwise specify sex|NN tumour|NN carcinoma|NN specify tumor|NN cell|NN tumor|NN specify 851|NN otherwise specify squamous cell|NN carcinoma|NN brenner|NN tumor|NN specify 717|NN
Ovarian cancer|Disease histologically genetically divide type|NN type|NN
type|NN cancer|NN low histological grade|NN include mucinous|NN clear-cel|NN carcinoma|NN
type|NN cancer|NN higher histological grade|NN include carcinoma|NN epithelial carcinoma|NN pathological specimen|NN ovarian carcinoma|NN
surface|NN tumour|NN known ovarian epithelial carcinoma|NN common type|NN Ovarian cancer|Disease represent approximately Ovarian cancer|Disease
include tumour|NN tumor|NN mucinous|NN
common tumor|NN malignant brenner|NP tumor|NN transitional cell|NN carcinoma|NN ovary|NN
Ovarian cancer|Disease develop epithelium|NN layer|NN cell|NN cover ovary|NN carcinoma|NN
people|NN epithelial ovarian carcinoma|NN serous carcinoma|NN proportion|NN estimate high low-grade|NN carcinoma|NN aggressive high-grade serous|NN carcinoma|NN typically respond well chemotherapy|NN hormonal treatment|NN carcinoma|NN thought begin fallopian tube|NN adenocarcinoma|NN psammoma body|NN
serous adenocarcinoma|NN resemble fallopian tube|NN epithelium|NN high-grade serous|NN adenocarcinoma|NN show|NN nuclear atypia|NN
time|NN carcinoma|NN bilateral case|NN spread ovary|NN time|NN diagnosis|NN
diameter|NN cm|NN carcinoma|NN
ovarian carcinoma|NN rare aggressive main subtype|NN pulmonary
typically fatal year|NN diagnosis|NN
small cell|NN ovarian carcinoma|NN overwhelmingly affect cause|NN high blood|NN calcium|NN level|NN affect ovary|NN
pulmonary small cell|NN Ovarian cancer|Disease usually affect ovary|NN older women|NN look|NN carcinoma|NN lung|NN primary peritoneal carcinoma|NN main article|NN primary peritoneal carcinoma|NN
primary peritoneal carcinoma|NN develop peritoneum|NN membrane|NN cover abdominal cavity|NN embryonic origin|NN ovary|NN
discuss classify Ovarian cancer|Disease affect ovary|NN develop even ovary|NN remove appear similar clear-cel carcinoma|NN
ovarian carcinoma|NN typically respond well chemotherapy|NN relate endometriosis|NN represent approximately endometrial cancer|NN
japanese women|NN develop Ovarian cancer|Disease frequently group|NN women|NN adenocarcinoma|NN cell|NN seen clear cell|NN carcinoma|NN sample|NN
adenocarcinoma|NN histopathologically similar clear cell|NN carcinoma|NN clear cell|NN hobnail cell|NN
represent approximately epithelial Ovarian cancer|Disease associate endometriosis|NN pelvic cavity|NN
typically early-stage therefore curable surgery|NN advance clear-cel|NN adenocarcinoma|NN approximately poor prognosis|NN resistant platinum|NN chemotherapy|NN
adenocarcinoma|NN make approximately epithelial Ovarian cancer|Disease
typically low-grade endometrioid|NN adenocarcinoma|NN good prognosis|NN
frequently co-occur endometriosis|NN endometrial cancer|NN mix müllerian|NN tumor|NN
mix müllerian|NN make Ovarian cancer|Disease
epithelial mesenchymal cell|NN visible tend poor prognosis|NN
include adenocarcinoma|NN mucinous|NN adenocarcinoma|NN main article|NN adenocarcinoma|NN
adenocarcinoma|NN make epithelial Ovarian cancer|Disease
similar intestinal cervical adenocarcinoma|NN actually metastase|NN appendiceal|NN colon|NN cancer|NN
advance mucinous|NN adenocarcinoma|NN poor prognosis|NN generally worse tumor|NN resistant platinum|NN chemotherapy|NN rare main article|NN
peritoney|NN refer collection|NN encapsulate mucous|NN material|NN abdominopelvic cavity|NN rarely cause primary|NN ovarian tumor|NN
commonly associate ovarian metastase|NN intestinal cancer|NN epithelial
cancer|NN cell|NN type|NN determine make epithelial Ovarian cancer|Disease comparatively poor prognosis|NN examine microscope|NN tumor|NN abnormal cell|NN arrang clump|NN sheet|NN
usually recognizable clump|NN serous cell|NN tumor|NN brenner|NP tumor|NN main article|NN brenner|NN tumor|NN
malignant|NP brenner|NP rare
dense fibrous stroma|NN area|NN transitional epithelium|NN squamous differentiation|NN
classify malignant brenner|NN tumor|NN brenner|NN tumor|NN focy|NN transitional cell|NN carcinoma|NN
transitional cell|NN carcinoma|NN component|NN typically poorly differentiate resemble urinary tract|NN cancer|NN transitional cell|NN carcinoma|NN main article|NN transitional cell|NN carcinoma|NN
transitional cell|NN carcinoma|NN represent Ovarian cancer|Disease
appear similar bladder|NN carcinoma|NN
prognosis|NN intermediate better epithelial cancer|NN worse malignant brenner|NN sex|NN tumor|NN main article|NN sex|NN tumor|NN
sex|NN tumor|NN granulosa cell|NN tumor|NN benign thecoma|NN sertoli-leydig cell|NN tumor|NN arrhenoblastoma|NN account|NN Ovarian cancer|Disease
occur frequently women|NN year|NN age|NN occur women|NN age|NN young girl|NN
typically aggressive usually unilateral therefore usually treate surgery|NN alone
sex|NN cord-stromal|NN main ovarian tumor|NN
different cell|NN mesenchyme|NN give rise|NN sex-cord|NN stromal tumor|NN
include fibroblast|NN endocrine cell|NN
symptom|NN sex-cord|NN stromal ovarian tumor|NN differ type|NN Ovarian cancer|Disease
common sign|NN symptom|NN include ovarian torsion|NN rupture|NN tumor|NN abdominal mass|NN hormonal disruption|NN
children|NN precocious pseudopuberty|NN occur cell|NN produce
tumor cause|NN abnormality|NN menstruation|NN excessive bleed infrequent menstruation|NN menstruation|NN postmenopausal|NN bleed|NN
tumor produce|NN cause occur time|NN endometrial cancer|NN breast|NN cancer|NN
sex-cordstromal|NN present|NN distinct symptom|NN
cell|NN cause|NN excessive hair|NN growth|NN due production|NN testosterone|NN androstenedione|NN cause syndrome|NN rare case|NN
stromal tumor|NN occur cause hormonal imbalance|NN benign fibroma|NN cause|NN ascite|NN hydrothorax|NN germ|NN cell|NN sex|NN tumor|NN common Ovarian cancer|Disease diagnose women|NN cell|NN tumor|NN
cell|NN common stromal tumor|NN make case|NN divide histologic|NN subtype|NN adult|NN cell|NN develop women|NN juvenile granulosa|NN develop puberty|NN age|NN
develop ovarian follicle|NN population|NN cell|NN surround cell|NN adult|NN cell|NN tumor|NN
adult|NN cell|NN tumor|NN characterize later onset|NN year|NN average|NN
tumor|NN produce high level|NN estrogen|NN cause characteristic symptom|NN endometrial hyperplasia|NN tender enlarge breast|NN postmenopausal|NN bleed|NN secondary amenorrhea|NN
mass|NN tumor|NN cause symptom|NN abdominal pain|NN distension|NN symptom|NN similar ectopic pregnancy|NN tumor|NN bleed rupture juvenile granulosa|NN cell|NN tumor|NN cell|NN tumor|NN
common women|NN age|NN particularly common puberty|NN stromal tumor|NN
stromal tumor|NN typically occur girl|NN puberty|NN women|NN age|NN germ cell|NN tumor|NN main article|NN germ|NN cell|NN
cell|NN tumor|NN ovary|NN develop ovarian germ|NN cell|NN cell|NN tumor|NN account|NN ovarian tumor|NN Ovarian cancer|Disease germ-cel tumor|NN teratoma benign
tend occur older women|NN germ|NN layer|NN tumor|NN develop squamous cell|NN carcinoma|NN tend occur young women|NN girl|NN make Ovarian cancer|Disease seen age|NN group|NN include yolk|NN sac|NN sinus|NN choriocarcinoma arise ovary|NN
germ-cel|NN isochromosome arm|NN chromosome|NN delet replace duplicate|NN germ-cel cancer|NN better prognosis|NN subtype|NN sensitive chemotherapy|NN
likely stage|NN diagnosis|NN overal metastasize frequently epithelial Ovarian cancer|Disease
addition|NN cancer|NN marker|NN use vary tumor|NN type|NN monitor beta-hcg|NN sinus|NN
typically discover become large palpable mass|NN
sex|NN cord|NN cause ovarian torsion|NN hemorrhage|NN children|NN precocious puberty|NN
frequently metastasize nearby lymph|NN node|NN especially pelvic lymph|NN node|NN common symptom|NN germ|NN cell|NN tumor|NN subacute abdominal pain|NN cause tumor|NN bleed|NN stretch ovarian capsule|NN
tumor|NN rupture cause|NN significant bleed|NN torse ovary|NN cause acute abdominal pain|NN occur tumor|NN
secrete hormone|NN change menstrual cycle|NN
cancer|NN discover routine|NN examination|NN cause symptom|NN
germ|NN cell|NN difficult normal menstrual cycle|NN puberty|NN cause pain|NN pelvic symptom|NN young woman|NN even believe symptom|NN pregnancy|NN seek treatment|NN due stigma|NN teen|NN pregnancy|NN
blood|NN test|NN karyotype human chorionic gonadotropin|NN liver|NN function|NN use diagnose germ|NN cell|NN tumor|NN potential|NN dysgenesis|NN
germ|NN cell|NN tumor|NN initially mistaken benign ovarian cyst|NN main article|NN
account|NN Ovarian cancer|Disease young women|NN likely germ|NN cell|NN tumor|NN metastasize|NN lymph|NN node|NN nodal metastase|NN occur 2530|NN case|NN tumor|NN mutation|NN kit|NN gene|NN mutation|NN known role|NN gastrointestinal stromal tumor|NN
people|NN karyotype|NN ovary|NN dysgenesis|NN x0|NN ovary|NN turner|NP syndrome|NN develop unilateral dysgerminoma|NN risk|NN gonadoblastoma|NN ovary|NN case|NN ovary|NN usually remove unilateral dysgerminoma|NN discover avoid risk|NN malignant tumor|NN
gonadoblastoma people|NN swyer|NN turner|NP syndrome|NN become malignant approximately case|NN
general dysgerminoma|NN bilateral time|NN
compose cell|NN differentiate further develop directly germ|NN cell|NN
contain approximately case|NN therefore cause elevate hcg|NN level|NN
gross appearance|NN typically pink tan-color|NN multiple lobe|NN solid
appear identical seminoma|NN close embryonic primordial germ|NN cell|NN large round clear cell|NN
nucley|NN uniform round square prominent nucleoly|NN cytoplasm|NN high level|NN glycogen|NN
prominent histologic feature|NN choriocarcinoma main article|NN
occur primary ovarian tumor|NN develop germ|NN cell|NN usually gestational disease|NN metastasize ovary|NN
primary ovarian choriocarcinoma|NN poor prognosis|NN occur pregnancy|NN
produce high level|NN hcg|NN cause early puberty|NN children|NN irregular heavy menstruation|NN menarche|NN immature solid|NN main article|NN immature teratoma|NN
immature solid teratoma|NN common type|NN ovarian germ|NN cell|NN tumor|NN make 4050 case|NN
characterize presence|NN disorganize tissue|NN arise embryonic germ|NN layer|NN mesoderm|NN endoderm|NN immature undifferentiate stem|NN cell|NN make malignant mature dermoid cyst|NN
different tissue|NN visible gross pathology|NN include bone|NN cartilage|NN hair|NN mucus|NN sebum|NN tissue|NN visible outside|NN appear solid mass|NN lobe|NN cyst|NN
large amount|NN neuroectoderm|NN organize sheet|NN tubule|NN amount|NN neural tissue|NN determine histologic grade|NN
immature teratoma|NN usually affect ovary|NN dermoid cyst|NN usually metastasize peritoneum|NN
cause mature teratoma|NN implant|NN grow abdomen|NN disease|NN call grow teratoma|NN syndrome|NN usually benign continue grow chemotherapy|NN necessitate further surgery|NN
mature immature teratoma|NN form|NN adhesion|NN make likely cause ovarian torsion|NN
specific marker|NN immature teratoma|NN antigen|NN ca-125|NN afp|NP sometime indicate immature teratoma|NN
stage|NN teratoma make majority|NN case|NN best prognosis|NN patient|NN survive year|NN stage|NN tumor|NN grade|NN treate unilateral surgery|NN
stage|NN tumor|NN make remain quarter|NN case|NN worse prognosis|NN 7388|NN patient|NN survive year|NN mature cyst|NN main article|NN cyst|NN
mature teratoma|NN dermoid|NN cyst|NN rare consist mostly benign tissue|NN develop menopause|NN
tumor|NN consist disorganize tissue|NN nodule|NN malignant tissue|NN various type|NN
common malignancy|NN squamous cell|NN carcinoma|NN adenocarcinoma|NN carcinoma|NN carcinoid tumor|NN tumor|NN malignant melanoma|NN sarcoma|NN sebaceous tumor|NN ovariy|NN part|NN dermoid cyst|NN
treate surgery|NN adjuvant platinum|NN chemotherapy|NN radiation|NN sac|NN sinus|NN tumor|NN main article|NN sac|NN tumor|NN
sac|NN formerly call sinus|NN make approximately ovarian germ|NN cell|NN malignancy|NN worst prognosis|NN ovarian germ|NN cell|NN
occur menarche|NN case|NN menarche|NN remain case|NN
people|NN yolk|NN sac|NN diagnose stage|NN
typically unilateral metastasis|NN occur peritoneal cavity|NN bloodstream|NN lung|NN
sac|NN grow quickly recur easily easily treatable recure
stage|NN yolk|NN sac|NN highly treatable 5-year disease|NN free survival|NN rate|NN stage|NN tumor|NN treatable survival|NN rate|NN
gross appearance|NN solid friable yellow necrotic hemorrhagic area|NN
contain cyst|NN degenerate rupture
yolk|NN sac|NN characterize presence|NN schiller-duval body|NN pathognomonic yolk|NN sac|NN reticular pattern|NN
sac|NN commonly secrete immunohistochemically stain presence|NN level|NN alpha-fetoprotein|NN blood|NN useful marker|NN recurrence|NN carcinoma|NN main article|NN carcinoma|NN
carcinoma|NN rare tumor|NN type|NN usually found mix tumor|NN develop directly germ|NN cell|NN terminally differentiate rare case|NN develop gonad|NN
develop further variety|NN neoplasm|NN yolk|NN sac|NN tumor|NN teratoma|NN
occur younger people|NN average age|NN diagnosis|NN secrete alpha-fetoprotein|NN case|NN hcg|NN
embryonal carcinoma|NN appear similar embryonic disc|NN made epithelial anaplastic|NN cell|NN disorganize sheet|NN gland-like space|NN papillary structure|NN main article|NN
polyembryoma immature form|NN teratoma|NN rare ovarian tumor|NN histologically characterize embryo-like body|NN structure|NN resemble germ|NN disk|NN yolk|NN sac|NN amniotic sac|NN
giant cell|NN occur squamous cell|NN carcinoma|NN
primary ovarian squamous cell|NN carcinoma|NN rare poor prognosis|NN advance
typically ovarian squamous cell|NN carcinoma|NN cervical metastase|NN area|NN differentiation|NN endometrioid tumor|NN derive mature mix tumor|NN
mix tumor|NN contain element|NN above class|NN tumor|NN histology|NN
class mix tumor|NN minor type|NN make tumor|NN mix carcinoma|NN combination|NN cell|NN type|NN mix Ovarian cancer|Disease typically serousendometrioid clear mix germ|NN cell|NN make approximately germ|NN cell|NN Ovarian cancer|Disease combination|NN yolk|NN sac|NN tumor|NN immature teratoma|NN
prognosis|NN treatment|NN vary base component|NN cell|NN type|NN secondary Ovarian cancer|Disease
Ovarian cancer|Disease secondary cancer|NN result|NN metastasis|NN primary cancer|NN elsewhere body|NN Ovarian cancer|Disease due metastase|NN rest|NN primary cancer|NN
citation|NN need common primary cancer|NN breast|NN cancer|NN colon|NN cancer|NN cancer|NN stomach|NN cancer|NN primary gastric cancer|NN metastasize ovary|NN call krukenberg|NN signet|NN ring|NN cell|NN mucinous cell|NN cancer|NN lymphoma|NN metastasize ovary|NN low malignant potential|NN
low malignant potential|NN ovarian call borderline|NN tumor|NN benign malignant feature|NN make approximately ovarian tumor|NN develop earlier epithelial Ovarian cancer|Disease age|NN
typically extensive invasion|NN tumor|NN area|NN stromal microinvasion|NN 3mm|NN tumor|NN
abnormal feature|NN increase mitosis|NN change|NN cell|NN size|NN nucleus|NN size|NN abnormal nucley|NN cell|NN stratification|NN small projection|NN cell|NN projection|NN
andor|NN characteristics|NN seen histological examination|NN histology|NN make overwhelm majority|NN advance lmp|NN
tumor|NN stage|NN stage|NN stage|NN implant|NN lmp tumor|NN non-invasive
Ovarian cancer|Disease stage use figo stage|NN system|NN use information|NN obtain surgery|NN include total abdominal hysterectomy|NN midline|NN laparotomy|NN removal|NN usually ovary|NN fallopian tube|NN usually omentum pelvic peritoneal wash|NN assessment|NN lymph|NN node|NN pelvic para-aortic lymph|NN node|NN suspect mucinous|NN biopsy|NN cytopathology|NN Ovarian cancer|Disease appear confine ovary|NN microscopically even cancer|NN stage completely cancer|NN presume stage|NN observe lymphatic metastase|NN ajcc stage|NN figo stage|NN
ajcc stage|NN system|NN describe extent|NN primary tumor|NN absence|NN presence|NN metastasis|NN nearby lymph|NN node|NN absence|NN presence|NN distant metastasis|NN m|NN common stage|NN diagnosis|NN stage|NN diagnose|NN adenocarcinoma|NN deposit|NN mesentery|NN small bowel|NN stage|NN Ovarian cancer|Disease stage|NN description|NN cancer|NN completely limit ovary|NN ia|NP involve ovary|NN capsule|NN intact tumor|NN ovarian surface|NN negative wash|NN ib|NN involve ovary|NN capsule|NN intact tumor|NN ovarian surface|NN negative wash|NN ic tumor|NN involve ovary|NN surgical spill|NN capsule|NN rupture tumor|NN ovarian surface|NN positive ascite|NN wash|NN pelvic extension|NN tumor|NN confine pelvis|NN primary peritoneal tumor|NN involve ovary|NN iia|NP tumor|NN found uterus|NN fallopian tube|NN iib tumor|NN elsewhere pelvis|NN cancer|NN found pelvis|NN retroperitoneal lymph|NN node|NN involve ovary|NN metastasis|NN lymph|NN node|NN microscopic extrapelvic|NN metastasis|NN metastasis|NN lymph|NN node|NN metastasis|NN mm|NN diameter|NN metastasis|NN greater mm|NN diameter|NN microscopic metastasis|NN peritoneum|NN regardless lymph|NN node|NN status|NN metastasis|NN peritoneum|NN equal cm|NN diameter|NN regardless lymph|NN node|NN status|NN metastasis|NN liver|NN spleen|NN capsule|NN metastasis|NN peritoneum|NN greater cm|NN diameter|NN regardless lymph|NN node|NN status|NN metastasis|NN liver|NN spleen|NN capsule|NN distant metastasis|NN ie outside peritoneum iva|NN pleural effusion|NN contain cancer|NN cell|NN metastasis|NN distant organ|NN parenchyma|NN spleen|NN liver|NN metastasis|NN inguinal extra-abdominal lymph|NN node|NN
stage|NN Ovarian cancer|Disease
stage|NN Ovarian cancer|Disease
stage|NN Ovarian cancer|Disease
stage|NN Ovarian cancer|Disease
ajcctnm stage|NN system|NN indicate tumor|NN develop spread|NN lymph|NN node|NN metastasis|NN stage|NN Ovarian cancer|Disease stage|NN description|NN primary tumor|NN assess evidence|NN limit ovaryovary ovary|NN intact capsule|NN surface|NN tumor|NN negative ascitesperitoneal|NN wash|NN ovary|NN intact capsule|NN surface|NN tumor|NN negative ascitesperitoneal|NN wash|NN ovary|NN rupture capsule|NN capsule|NN surface|NN tumor|NN positive ascitesperitoneal|NN wash|NN ovary|NN pelvis|NN extension|NN implantation|NN expansion|NN uterus|NN fallopian tube|NN negative wash|NN expansion|NN pelvic tissue|NN negative wash|NN expansion|NN pelvic tissue|NN positive ascitesperitoneal|NN wash|NN ovary|NN metastasize pelvis|NN peritoneum|NN liver|NN capsule|NN microscopic metastasis|NN metastasis|NN cm|NN diameter|NN metastasis|NN greater cm|NN diameter|NN regional lymph|NN node|NN metastasis|NN assess metastasis|NN present m|NN distant metastasis|NN metastasis|NN metastasis|NN present|NN liver|NN capsule|NN liver|NN parenchyma|NN confirm pleural effusion|NN
ajcctnm stage|NN correlate figo stage|NN ia|NP t1a|NP ib|NN t1b|NN ic t1c|NN iia|NP t2a|NP iib|NP t2b|NP grade|NN
grade|NN well differentiate cell|NN look similar normal tissue|NN best prognosis|NN
grade|NN tumor|NN call moderately made cell|NN resemble normal tissue|NN
grade|NN worst prognosis|NN cell|NN abnormal refer poorly differentiate
metastasis Ovarian cancer|Disease common abdomen|NN occur cancer|NN cell|NN burst ovarian capsule|NN able move freely peritoneal cavity|NN
Ovarian cancer|Disease metastase|NN usually grow surface|NN organ|NN common omentum|NN peritoneal line|NN
cancer|NN cell|NN travel lymphatic system|NN metastasize|NN lymph|NN node|NN connect ovary|NN blood|NN vessel|NN ie lymph|NN node|NN infundibulopelvic ligament|NN broad ligament|NN round ligament|NN
commonly affect group|NN include paraaortic|NN external iliac|NN inguinal lymph|NN node|NN
usually Ovarian cancer|Disease metastasize liver|NN lung|NN brain|NN kidney|NN recurrent disease|NN differentiate Ovarian cancer|Disease form|NN cancer|NN screen|NN
simple reliable way|NN test|NN Ovarian cancer|Disease women|NN sign|NN symptom|NN
screen|NN recommend women|NN average risk|NN evidence|NN support reduction|NN death|NN high rate|NN false positive test|NN lead surgery|NN accompany risk|NN pap test|NN screen Ovarian cancer|Disease
Ovarian cancer|Disease usually palpable advance stage|NN screen|NN recommend use measurement|NN level|NN ultrasound|NN palpation|NN women|NN average risk|NN
risk|NN develop Ovarian cancer|Disease genetic factor|NN reduce
genetic predisposition|NN benefit screen|NN
high risk|NN group|NN benefit earlier detection|NN
Ovarian cancer|Disease low prevalence|NN even high-risk group|NN women|NN age|NN screen|NN women|NN average risk|NN likely give ambiguous result|NN detect problem|NN require treatment|NN
ambiguous result|NN likely detection|NN treatable problem|NN usual response|NN ambiguous result|NN invasive intervention|NN women|NN average risk|NN potential harm|NN screen|NN indication|NN outweigh potential benefit|NN
purpose|NN screen|NN diagnose Ovarian cancer|Disease early stage|NN likely treate successfully
screen|NN ultrasound|NN pelvic examination|NN ca-125|NN level|NN use instead preventive surgery|NN women|NN brca1 mutation|NN
strategy|NN show success|NN prevention|NN
people|NN strong genetic risk|NN Ovarian cancer|Disease consider surgical removal|NN ovary|NN preventive measure|NN
completion|NN childbear|NN year|NN
reduce chance|NN develop breast|NN cancer|NN Ovarian cancer|Disease people|NN high risk|NN
women|NN gene|NN mutation|NN usually fallopian tube|NN remove time|NN increase risk|NN fallopian tube|NN cancer|NN
statistics|NN overestimate risk|NN reduction|NN study
people|NN significant family|NN history|NN Ovarian cancer|Disease refer genetic counselor|NN see test|NN brca mutation|NN beneficial use|NN oral contraceptive|NN absence|NN period|NN menstrual cycle|NN tubal ligation|NN reduce risk|NN association|NN develop Ovarian cancer|Disease ovarian stimulation|NN infertility|NN treatment|NN
link Ovarian cancer|Disease
human papillomavirus|NN infection|NN smoke|NN talc|NN identify increase risk|NN develop Ovarian cancer|Disease management|NN
determine ovarian fallopian tube|NN primary peritoneal cancer|NN present treatment|NN schedul gynecologic|NN physician|NN train treat cancer|NN woman reproductive system|NN
perform surgery|NN give chemotherapy|NN women|NN Ovarian cancer|Disease
treatment|NN plan|NN develop
treatment|NN usually involve surgery|NN chemotherapy|NN sometime radiotherapy|NN regardless subtype|NN Ovarian cancer|Disease surgical treatment|NN sufficient malignant tumor|NN confine ovary|NN
addition|NN chemotherapy|NN require aggressive tumor|NN confine ovary|NN
patient|NN advance disease|NN combination|NN surgical reduction|NN combination|NN chemotherapy|NN regimen|NN standard
borderline|NN even follow spread|NN outside|NN ovary|NN manage well surgery|NN chemotherapy|NN seen useful second-look surgery|NN maintenance|NN chemotherapy|NN show provide benefit|NN surgery|NN
surgery|NN standard|NN care|NN decade|NN necessary obtain specimen|NN diagnosis|NN
surgery|NN depend extent|NN nearby invasion|NN tissue|NN cancer|NN diagnose
extent|NN cancer|NN describe assign stage|NN presume type|NN grade|NN cancer|NN
gynecological surgeon|NN remove unilateral oophorectomy|NN ovary|NN bilateral
fallopian tube|NN uterus|NN hysterectomy|NN omentum omentectomy|NN remove
typically organ|NN remove
low-grade unilateral stage-ia|NN cancer|NN involve ovary|NN unrupture fallopian tube|NN remove
especially young people|NN wish preserve fertility|NN
risk|NN microscopic metastase|NN exist stage|NN complet metastase|NN found second|NN surgery|NN remove remain ovary|NN uterus|NN need acid|NN administer surgery|NN reduce need|NN blood|NN transfusion|NN due blood|NN loss|NN surgery|NN
tumor|NN premenopausal woman|NN determine low malignant potential|NN tumor|NN surgery|NN clearly stage|NN cancer|NN affect ovary|NN remove
postmenopausal|NN women|NN low malignant potential|NN hysterectomy|NN bilateral salpingo-oophorectomy|NN prefer option|NN
stage appendix|NN examine remove
particularly important tumor|NN children|NN adolescent|NN Ovarian cancer|Disease surgeon|NN typically attempt preserve ovary|NN allow completion|NN puberty|NN cancer|NN spread alway possible
dysgerminoma particular tend affect ovary|NN present ovary|NN people|NN low-grade well-differentiate|NN typically treate surgery|NN curative general germ|NN cell|NN treate unilateral surgery|NN cancer|NN widespread fertility|NN factor|NN
advance cancer|NN complete removal|NN option|NN tumor|NN possible remove procedure|NN call surgery|NN
surgery|NN alway successful likely successful women|NN extensive metastase|NN peritoneum|NN iv disease|NN cancer|NN transverse fissure|NN liver|NN diaphragm|NN large area|NN ascite|NN
surgery|NN usually complete debulk|NN associate better outcome|NN women|NN macroscopic evidence|NN disease|NN debulking|NP median survival|NN month|NN oppose month|NN complete surgery|NN remove metastase|NN cell|NN resistant chemotherapy|NN remove clump|NN cell|NN dy remove
allow chemotherapy|NN better reach remain cancer|NN cell|NN likely fast-grow therefore
debulk surgery|NN protocol|NN use chemotherapy|NN give surgery|NN perform chemotherapy|NN finish debulk|NN definitive study|NN complet show approximately equivalent primary debulk surgery|NN term|NN survival|NN show slightly lower morbidity|NN
different surgical procedure|NN employ treat Ovarian cancer|Disease
stage|NN cancer|NN keyhole|NN surgery|NN use metastase|NN found
advance cancer|NN laparoscopy|NN use debulk metastase|NN require access|NN entire peritoneal cavity|NN
extent|NN cancer|NN procedure|NN include bilateral salpingo-oophorectomy|NN biopsy|NN peritoneum|NN abdominal lymphatic system|NN bowel|NN resection|NN diaphragm|NN strip|NN resection|NN even posterior pelvic exenteration|NN
fully stage|NN Ovarian cancer|Disease lymphadenectomy|NN include surgery|NN significant survival|NN benefit|NN practice|NN happen particularly important germ|NN cell|NN frequently metastasize nearby lymph|NN node|NN
Ovarian cancer|Disease recur secondary surgery|NN sometime treatment|NN option|NN
depend easily tumor|NN remove fluid|NN accumulate abdomen|NN overal health|NN helpful people|NN surgery|NN generalist|NN epithelial Ovarian cancer|Disease secondary surgery|NN effective dysgerminoma|NN immature teratoma|NN
major side|NN effect|NN oophorectomy|NN younger women|NN early menopause|NN cause osteoporosis|NN
surgery|NN hormone|NN replacement|NN therapy|NN consider especially younger women|NN
therapy|NN consist combination|NN estrogen|NN progesterone|NN alone
alone safe hysterectomy|NN uterus|NN present unoppose estrogen|NN dramatically raise risk|NN endometrial cancer|NN therapy|NN surgery|NN change survival|NN rate|NN people|NN Ovarian cancer|Disease surgery|NN typically hospitalize afterward day|NN spend month|NN recover home|NN surgery|NN outcome|NN best hospital|NN large number|NN Ovarian cancer|Disease surgery|NN
unclear laparoscopy|NN laparotomy|NN better worse stage|NN Ovarian cancer|Disease apparent difference|NN total abdominal hysterectomy|NN hysterectomy|NN advance cancer|NN
approximately people|NN surgery|NN advance Ovarian cancer|Disease die week|NN surgery|NN mortality|NN rate|NN aggressive surgery|NN associate better outcome|NN advance stage|NN Ovarian cancer|Disease
general standard|NN care|NN Ovarian cancer|Disease decade|NN variable protocol|NN
use surgery|NN treat residual disease|NN appropriate
case|NN reason|NN perform chemotherapy|NN follow surgery|NN
call chemotherapy|NN common tumor|NN completely remove optimally debulk surgery|NN
show increase|NN survival|NN reduce risk|NN complication|NN surgery|NN
unilateral salpingo-oophorectomy|NN surgery|NN perform additional chemotherapy|NN call adjuvant chemotherapy|NN give chemotherapy|NN use stage|NN cancer|NN typically tumor|NN high histologic|NN grade|NN grade|NN highest substage|NN stage|NN cancer|NN optimally stage surgery|NN use adjuvant chemotherapy|NN tumor|NN completely remove surgery|NN cancer|NN stage|NN extend survival|NN show extend overal survival|NN chemotherapy|NN curative approximately advance Ovarian cancer|Disease curative malignant germ|NN cell|NN epithelial
chemotherapy Ovarian cancer|Disease typically consist group|NN platinum-base drug|NN combine
common therapy|NN include cisplatin|NN doxorubicin|NN
typically give combination|NN paclitaxel|NN docetaxel typical combination|NN carboplatin carboplatin|NN superior cisplatin|NN toxic side|NN effect|NN generally allow improve quality|NN life|NN comparison|NN similarly effective three-drug|NN regimen|NN found effective platin alone nonplatin alone effective platin nonplatin combination|NN give intravenously peritoneal cavity|NN intraperitoneal chemotherapy|NN associate longer progression-free survival|NN overal survival|NN cause adverse side|NN effect|NN intravenous chemotherapy|NN mainly use cancer|NN optimally debulk
chemotherapy|NN highly effective Ovarian cancer|Disease mainly spread peritoneal cavity|NN higher dose|NN drug|NN reach tumor|NN way|NN
cause intravenous iron|NN found effective oral iron|NN supplement|NN reduce need|NN blood|NN transfusion|NN typical cycle|NN treatment|NN involve treatment|NN week|NN repeate week|NN week|NN cycle|NN treatment|NN effective week|NN germ-cel malignancy|NN treate differently Ovarian cancer|Disease regimen|NN bleomycin|NN cisplatin|NN bep|NN use day|NN chemotherapy|NN administer week|NN cycle|NN germ|NN cell|NN show cause infertility|NN birth|NN defect|NN miscarriage|NN maintenance|NN chemotherapy|NN show effective
people|NN mutation|NN platinum|NN chemotherapy|NN effective germ-cel|NN malignant sex-cordstromal|NN treate chemotherapy|NN tumor|NN typically responsive
Ovarian cancer|Disease recur consider partially platinum-resistant base time|NN recurrence|NN treate partially platinum-sensitive cancer|NN recure month|NN treatment|NN platinum-resistant|NN cancer|NN interval|NN month|NN
chemotherapy|NN give cancer|NN become symptomatic difference|NN survival|NN seen treate asymptomatic elevate ca-125|NN symptomatic recurrence|NN
medical citation|NN need
tumor platin|NN drug|NN choice|NN chemotherapy|NN combination|NN cytotoxic agent|NN
include combine liposomal doxorubicin|NN carboplatin-doublet therapy|NN combine paclitaxel|NN increase efficacy|NN case|NN
potential adjuvant therapy|NN platinum-sensitive recurrence|NN olaparib improve survival|NN show improve overal survival|NN parp inhibitor|NN approve fda|NN use|NN Ovarian cancer|Disease previously treate chemotherapy|NN recurrent germ|NN cell|NN additional cycle|NN chemotherapy|NN first-line treatment|NN tho|NN treate surgery|NN platin|NN
tumor|NN determine platinum-resistant dactinomycin|NN cyclophosphamide|NN combination|NN paclitaxel|NN use second-line therapy|NN
tumor|NN high-efficacy chemotherapy|NN option|NN
regimen|NN high response|NN rate|NN single-drug regimen|NN pegylate liposomal|NN use case|NN use people|NN intestinal blockage|NN
use alone possible regimen|NN combine doxorubicin|NN cisplatin|NN topotecan|NN cyclophosphamide|NN see care|NN
radiation|NN therapy|NN
effectively treate radiation|NN cause infertility|NN phase favor|NN chemotherapy|NN radiation|NN therapy|NN improve survival|NN people|NN tumor|NN
stage|NN cancer|NN radiation|NN therapy|NN use surgery|NN possibility|NN residual disease|NN pelvis|NN abdomen|NN cancer-free
radiotherapy|NN use palliative care|NN advance cancer|NN
typical course|NN radiotherapy|NN Ovarian cancer|Disease day|NN week|NN week|NN
common side|NN effect|NN radiotherapy|NN include constipation|NN frequent urination|NN therapy|NN
fact|NN ovarian tumor|NN estrogen receptor|NN Ovarian cancer|Disease rarely responsive hormonal treatment|NN
alone effect|NN cancer|NN tamoxifen|NN rarely effective women|NN borderline|NN malignancy|NN Ovarian cancer|Disease stromal Ovarian cancer|Disease receive hormonal therapy|NN
topic|NN current research|NN Ovarian cancer|Disease
case|NN antibody|NN drug|NN topic|NN active research|NN use treat advance cancer|NN chemotherapy|NN approve use|NN european union|NN follow-up|NN
specific follow-up|NN depend example|NN type|NN stage|NN Ovarian cancer|Disease treatment|NN presence|NN symptom|NN
usually check-up|NN appointment|NN made month|NN initially follow twice year|NN year|NN epithelial Ovarian cancer|Disease common test|NN follow-up|NN level|NN
treatment|NN base elevate ca-125 level|NN symptom|NN increase side|NN effect|NN prolongation|NN life|NN implication|NN outcome|NN ca-125 test|NN discuss take recommendation|NN 2014|NN recurrent cancer|NN present ca-125 level|NN twice normal treate recurrence|NN detect ca-125|NN improve survival|NN
women|NN tumor follow-up|NN test|NN generally include afp|NN human chorionic gonadotropin|NN
women|NN stromal cancer|NN test|NN hormone|NN testosterone|NN sometime helpful inhibin|NN useful monitor progress|NN tumor|NN along inhibit substance|NN
afp|NP use monitor tumor|NN lactate|NN dehydrogenase|NN isozyme|NN use test|NN recurrence|NN
women|NN Ovarian cancer|Disease need routine|NN surveillance|NN image|NN monitor cancer|NN new symptom|NN appear tumor|NN marker|NN begin rise image|NN indication|NN discourage unlikely detect recurrence|NN improve survival|NN cost|NN side|NN effect|NN ct|NN image|NN use desire common tumor|NN easily image image|NN use monitor progress|NN treatment|NN care|NN
care|NN focuse relieve symptom|NN increase maintain quality|NN life|NN
type|NN treatment|NN purpose|NN cure cancer|NN make woman|NN comfortable live cancer|NN cure
recommend part|NN treatment|NN plan|NN person|NN advance Ovarian cancer|Disease patient|NN significant symptom|NN platinum-refractory|NN platinum-resistant|NN case|NN palliative chemotherapy|NN main treatment|NN
care|NN entail treatment|NN symptom|NN complication|NN cancer|NN pain|NN nausea|NN constipation|NN ascite|NN bowel|NN obstruction|NN pleural effusion|NN mucositis|NN
especially cancer|NN advance|NN become incurable treatment|NN symptom|NN become main goal|NN therapy|NN
care|NN entail help decision-make|NN hospice|NN care|NN appropriate prefer place|NN patient|NN end|NN life|NN care|NN
bowel|NN obstruction|NN treate palliative surgery|NN colostomy|NN ileostomy|NN internal bypass|NN medicine|NN surgery|NN show increase|NN survival|NN time|NN surgery|NN result short bowel|NN syndrome|NN fistula|NN re-obstruction|NN possible extent|NN obstruction|NN treatment|NN complication|NN include total parenteral nutrition|NN low-residue diet|NN palliative|NN adequate pain|NN control|NN bowel|NN obstruction|NN treate octreotide|NN palliative surgery|NN option|NN
cancer|NN block ureter|NN relieve nephrostomy|NN ureteric stent
relieve repeate paracentesis|NN placement|NN drain|NN increase comfort|NN effusion|NN treate similar manner|NN repeate thoracentesis|NN placement|NN drain|NN
radiation|NN therapy|NN use part|NN palliative care|NN advance Ovarian cancer|Disease help shrink cause symptom|NN radiotherapy|NN typically last treatment|NN shorter course|NN therapy|NN radiotherapy|NN use palliation|NN germ|NN cell|NN care|NN
Ovarian cancer|Disease significant effect|NN quality|NN life|NN psychological health|NN well-be|NN
available help need|NN social support|NN
Ovarian cancer|Disease survivor|NN report good quality|NN life|NN optimism|NN
report spiritual change|NN help find mean|NN experience|NN
describe loss|NN faith|NN diagnosis|NN Ovarian cancer|Disease
gone treatment|NN sometime experience|NN social isolation|NN benefit|NN relationship|NN survivor|NN
frustration|NN guilt|NN describe express inability|NN care|NN family|NN
body|NN image|NN change|NN occur due hair|NN loss|NN removal|NN ovary|NN reproductive structure|NN scar|NN
improvement|NN hair|NN grow
sexual issue|NN develop
removal|NN ovary|NN result|NN menopause|NN result painful intercourse|NN vaginal dryness|NN loss|NN sexual desire|NN tire
prognosis|NN better younger survivor|NN impact|NN sexuality|NN substantial
anxiety|NN depression|NN distress|NN present survive Ovarian cancer|Disease higher rate|NN general population|NN psychosocial problem|NN develop family|NN member|NN
emotional effect|NN include fear|NN death|NN sadness|NN memory|NN problem|NN difficulty|NN concentrate
optimism|NN adopt begine|NN treatment|NN likely develop distress|NN
fear|NN cancer|NN recure difficulty|NN express joy|NN even
treatment|NN woman|NN undergoe likely loss|NN hope|NN express
women|NN cope reduce negative psychosocial effect|NN number|NN strategy|NN
activity|NN spend|NN additional time|NN family|NN friend|NN ignor statistics|NN increase involvement|NN spiritually-base event|NN adaptive relative five-year survival|NN invasive epithelial Ovarian cancer|Disease stage|NN
Ovarian cancer|Disease usually relatively poor prognosis|NN
disproportionately deadly lack clear early detection|NN screen|NN test|NN mean|NN case|NN diagnose reach advance stage|NN
Ovarian cancer|Disease metastasize early development|NN diagnose
tumor|NN readily low-grade
typically tumor|NN cell|NN begin metastasize grow peritoneal cavity|NN women|NN present Ovarian cancer|Disease stage-iiy cancer|NN spread ovary|NN
Ovarian cancer|Disease shed|NN cell|NN naturally occure fluid|NN abdominal cavity|NN
cell|NN implant abdominal peritoneal structure|NN uterus|NN urinary bladder|NN bowel|NN line|NN bowel|NN wall|NN omentum|NN form new tumor|NN growth|NN cancer|NN even suspect
five-year survival|NN rate|NN stage|NN Ovarian cancer|Disease one-year survival|NN rate|NN ten-year survival|NN rate|NN case|NN diagnosis|NN made early disease|NN cancer|NN confine primary site|NN five-year survival|NN rate|NN 927 women|NN advance disease|NN respond initial treatment|NN attain complete remission|NN half|NN women|NN experience recurrence|NN year|NN treatment|NN brain|NN metastasis|NN common stage|NN cancer|NN occur cancer|NN stage
people|NN brain|NN metastase|NN survive median|NN month|NN surgery|NN chemotherapy|NN whole brain|NN radiation|NN therapy|NN improve survival|NN
Ovarian cancer|Disease survival|NN vary significantly subtype|NN
favorable prognosis|NN
early stage|NN five-year survival|NN rate|NN diagnose stage|NN stage-iiy five-year survival|NN treate chemotherapy|NN incomplete surgical removal|NN two-year survival|NN rate|NN
malignancy|NN favorable prognosis|NN slow-grow metastatic disease|NN survive decade|NN low malignant potential|NN usually bad prognosis|NN invasive tumor|NN implant|NN found peritoneal cavity|NN
complication|NN Ovarian cancer|Disease include spread|NN cancer|NN organ|NN progressive function|NN loss|NN various organ|NN ascite|NN intestinal obstruction|NN fatal
intestinal obstruction|NN multiple site|NN common proximate cause|NN death|NN intestinal obstruction|NN Ovarian cancer|Disease true obstruction|NN tumor|NN block intestinal lumen|NN pseudo-obstruction|NN tumor|NN prevent normal peristalsis|NN continuous accumulation|NN ascite|NN treate place drain|NN self-drain factor|NN
number|NN prognostic factor|NN Ovarian cancer|Disease
positive prognostic factor|NN indicate better chance|NN survival|NN include residual disease|NN surgery|NN stage|NN complete macroscopic resection|NN stage|NN brca2|NN mutation|NN young age|NN year|NN type|NN low histologic|NN grade|NN early stage|NN co-occurrence|NN endometrial cancer|NN low ca-125|NN level|NN
conflict evidence|NN brca1|NN prognostic factor|NN
conversely negative prognostic factor|NN indicate worse chance|NN survival|NN include rupture|NN ovarian capsule|NN surgery|NN older age|NN year|NN type|NN stage|NN high histologic grade|NN clear cell|NN type|NN upper abdominal involvement|NN high ca-125|NN level|NN presence|NN tumor|NN cell|NN blood|NN elevate cyclooxygenase-2|NN
expression|NN various mrna|NN prognostic Ovarian cancer|Disease
high level|NN drosha|NN associate improve survival|NN high level|NN hif1a|NN polymerase|NN associate worse survival|NN
cancer positive wt1|NN carry worse prognosis|NN positive cancer|NN better prognosis|NN survival|NN rate|NN
overal five-year survival|NN rate|NN type|NN Ovarian cancer|Disease present stage|NN grade|NN stage|NN survival|NN 9095 grade|NN survival|NN low grade|NN intermediate grade|NN high grade|NN
survival|NN rate|NN give different type|NN Ovarian cancer|Disease american cancer|NN society|NN come national cancer|NN institute|NN base patient|NN diagnose
epithelial Ovarian cancer|Disease stage|NN five-year survival|NN rate|NN ia|NP ib|NP ic|NP iia|NP iib|NP stromal tumor|NN stage|NN five-year survival|NN rate|NN cell|NN tumor|NN ovary|NN stage|NN five-year survival|NN rate|NN fallopian tube|NN carcinoma|NN stage|NN five-year survival|NN rate|NN low malignant potential|NN stage|NN five-year survival|NN rate|NN rate|NN
Ovarian cancer|Disease frequently recur treatment|NN
overal 5-year period|NN stage|NN cancer|NN recur
recurrence|NN abdomen|NN recurrence|NN occur advance disease|NN typically occur month|NN initial treatment|NN month|NN survival|NN
treate disease-free interval|NN tend shorten chemoresistance increase|NN recurrence|NN dysgerminoma|NN recur likely recur year|NN diagnosis|NN malignant germ|NN cell|NN recur year|NN time|NN
cell|NN poor prognosis|NN relapse long-term survival|NN rate|NN low malignant potential|NN rarely relapse|NN even surgery|NN treatment|NN choice|NN tumor relapse|NN unilateral surgery|NN previously unaffect ovary|NN typically easily treate surgery|NN
advance tumor|NN take year|NN relapse|NN relapse treate surgery|NN tumor|NN change histological characteristics|NN grown quickly
case|NN significant ascite|NN chemotherapy|NN use
usually indicate rise level|NN progress symptomatic relapse|NN month|NN recurrent sex|NN tumor|NN typically unresponsive treatment|NN aggressive
deadly gynecologic|NN cancer|NN epidemiology|NN death|NN Ovarian cancer|Disease inhabitant|NN data|NN
number|NN new case|NN occure develop country|NN compare develop country|NN people|NN dy Ovarian cancer|Disease
increase|NN 113000|NN number|NN new case|NN year|NN europe|NP approximately women|NN europe|NP lithuania|NP latvia|NP ireland|NP slovakia|NP czech republic|NN highest incidence|NN Ovarian cancer|Disease portugal|NP cyprus|NP lowest incidence|NN 2008|NN five-year survival|NN rate|NN
increase survival|NN rate|NN unit state|NN Ovarian cancer|Disease case|NN diagnose age|NN group|NN
united|NP states|NP estimate new case|NN diagnose women|NN dy Ovarian cancer|Disease
new diagnose|NN sex-cord stromal tumor|NN
2014|NN diagnose|NN epithelial Ovarian cancer|Disease made yearly overal lifetime|NN risk|NN Ovarian cancer|Disease affect cause|NN death|NN women|NN united|NP states|NP fifth-most common cancer|NN women|NN fourth-most common cause|NN cancer|NN death|NN decrease|NN made ninth-most common cancer|NN women|NN
risk|NN develop specific type|NN Ovarian cancer|Disease vary
cell|NN sex|NN tumor|NN common epithelial
number|NN new case|NN year|NN women|NN women|NN respectively
young people|NN stromal tumor|NN germ|NN cell|NN total|NN overal Ovarian cancer|Disease Ovarian cancer|Disease represent approximately cancer|NN diagnose women|NN united|NP kingdom|NP
common cancer|NN uk|NP women|NN uk|NP incidence|NN rate|NN whole population|NN
unit kingdom|NN approximately 70007100 yearly diagnose|NN 4200 death|NN risk|NN uk|NP similar
ashkenazy jewish women|NN carry mutate brca|NN allele|NN time|NN rest|NN population|NN give higher risk|NN develop Ovarian cancer|Disease fifth-lead cause|NN cancer-relate death|NN 2008|NP estimate Ovarian cancer|Disease fifth-most common cancer|NN women|NN uk|NP women|NN diagnose disease|NN fifth-most common cause|NN cancer|NN death|NN women|NN women|NN dy ethnicity|NN
black women|NN twice risk|NN sex|NN cord-stromal|NN compare non-black women|NN older women|NN
incidence|NN rate|NN women|NN approximately rate|NN Ovarian cancer|Disease 2008 decrease women|NN 4049 age|NN cohort|NN 5064 age|NN cohort|NN Ovarian cancer|Disease commonly diagnose menopause|NN age|NN
percent|NN Ovarian cancer|Disease occur women|NN age|NN women|NN older women|NN likely present advance Ovarian cancer|Disease pregnancy|NN
germ|NN cell|NN type|NN Ovarian cancer|Disease likely occur pregnancy|NN
typically diagnose adnexal mass|NN found examination|NN pregnancy|NN tumor|NN seen ultrasound|NN parent|NN level|NN alpha-fetoprotein|NN elevate
cyst|NN dysgerminoma|NN common germ|NN cell|NN pregnancy|NN
cell|NN diagnose pregnancy|NN unlikely metastasize treate surgery|NN case|NN chemotherapy|NN carry risk|NN birth|NN defect|NN
sac|NN immature teratoma|NN grow particularly quickly usually treate chemotherapy|NN even pregnancy|NN optimally debulk treate childbirth|NN animal|NN
report equine mare|NN
report tumor|NN type|NN include cystadenocarcinoma|NN particularly cell|NN tumor|NN research|NN screen|NN
screen|NN hysteroscopy|NP obtain cell|NN sample|NN obtain histological examination|NN develop
similar current pap|NN smear|NN use detect cervical cancer|NN uk|NP collaborative trial|NN Ovarian cancer|Disease screen|NN test screen|NN technique|NN combine blood|NN test|NN ultrasound|NN study|NN suggest screen|NN procedure|NN effective result|NN publish conclusive evidence|NN screen|NN save live|NN long-term result|NN trial|NN extend publish definitive result|NN end|NN
major problem|NN screen|NN clear progression|NN disease|NN stage|NN noninvasive stage|NN invasive seen possible find cancer|NN reach|NN stage|NN
problem|NN screen|NN method|NN tend find suspicious lesion|NN cancer|NN malignancy|NN assess surgery|NN roca method|NN combine ultrasonography|NN research high-risk women|NN determine viable screen|NN method|NN
investigate normal-risk women|NN show promise|NN wider population|NN study|NN progress|NN determine screen|NN help|NN detect cancer|NN earlier people|NN mutation|NN research|NN
research|NN various prognostic factor|NN Ovarian cancer|Disease go
recent research|NN show predict lower survival|NN higher stage|NN cancer|NN research|NN investigate benefit|NN surgery|NN recurrent Ovarian cancer|Disease
active area|NN research|NN immunotherapy|NN show effective trial|NN antibody|NN inhibitor|NN slow growth|NN new blood|NN vessel|NN cancer|NN show promise result|NN especially combination|NN pazopanib|NN slow process|NN blood|NN vessel|NN growth|NN
particularly effective preliminary study|NN stage-iiy|NN cancer|NN cite response|NN rate|NN investigate particularly Ovarian cancer|Disease pharmacology|NN
inhibitor|NN highly investigate potential treatment|NN 2000|NN 2010|NN side|NN effect|NN drug|NN particularly well tolerate survival|NN benefit|NN confirm
kinase|NN inhibitor|NN interest|NN tend highly toxic cause|NN
investigate drug|NN selumetinib mapk inhibitor|NN
improve survival|NN correlate mutation|NN found
combine platinum|NN chemotherapy|NN combination|NN positive preliminary result|NN pf|NN equivocal result|NN overal survival|NN
disadvantage|NN treatment|NN side|NN effect|NN profile|NN include high blood|NN pressure|NN proteinuria|NN
drug|NN exacerbate bowel|NN disease|NN lead fistulae|NN bowel|NN perforation|NN
consist antifolate|NN conjugate clinical trial|NN prove beneficial folate|NN receptor|NN overexpress Ovarian cancer|Disease potential immunotherapy|NN trastuzumab active positive|NN her2neu mutation|NN angiogenesis|NN inhibitor|NN investigate potential Ovarian cancer|Disease treatment|NN
research combination|NN recurrent Ovarian cancer|Disease
angiogenesis|NN inhibitor|NN investigate
monoclonal antibody|NN farletuzumab|NN research adjuvant|NN traditional chemotherapy|NN
type|NN immunotherapy|NN involve vaccine|NN
alternative|NN chemotherapy|NN regimen|NN cycle|NN carboplatin|NN current topic|NN research|NN germ|NN cell|NN malignancy|NN
chemotherapy|NN investigation|NN 2000|NN 2010|NN potential|NN deliver higher dose|NN cytotoxic agent|NN
preliminary trial|NN cisplatin|NN show well tolerate improve survival|NN tolerable regimen|NN research research intraperitoneal chemotherapy|NN agent|NN
specific chemotherapy|NN regimen|NN rare clear-cel cancer|NN investigation|NN combine cisplatin|NN
inhibitor|NN show promise|NN early trial|NN particularly people|NN gene|NN mutation|NN brca protein|NN interact parp pathway|NN
study recurrent Ovarian cancer|Disease general|NN preliminary study|NN show longer
specifically show greater survival|NN compare doxorubicin|NN treatment|NN investigate
clear predictive responsiveness|NN parp inhibitor|NN parp inhibitor|NN research brca-positive|NN recurrent advance Ovarian cancer|Disease
parp inhibitor|NN test recurrent Ovarian cancer|Disease
kinase|NN inhibitor|NN investigational drug|NN class|NN application|NN Ovarian cancer|Disease
inhibitor|NN receptor|NN tyrosine|NN kinase|NN inhibitor|NN group|NN cediranib|NN show increase|NN progression|NN free survival|NN benefit|NN overal survival|NN investigate preliminary research|NN show combine platin|NN recurrent Ovarian cancer|Disease increase time|NN second|NN recurrence|NN month|NN increase survival|NN month|NN tyrosine|NN kinase|NN inhibitor|NN use combination|NN paclitaxel|NN carboplatin|NN platinum-sensitive cancer|NN mutation|NN
research potential therapy|NN combination|NN cyclophosphamide|NN people|NN recurrence|NN
deacetylase inhibitor|NN area|NN research|NN
hormone|NN therapy|NN topic|NN current research|NN Ovarian cancer|Disease particularly value|NN certain medication|NN use treat breast|NN cancer|NN
include tamoxifen|NN
preliminary study|NN show benefit|NN tamoxifen|NN small number|NN people|NN advance Ovarian cancer|Disease
help slow stop growth|NN receptor|NN positive Ovarian cancer|Disease
investigate postmenopausal|NN people|NN receptor-positive cancer|NN
research|NN mitigate side|NN effect|NN Ovarian cancer|Disease treatment|NN ongo
radiation|NN fibrosis|NN formation|NN scar|NN tissue|NN area|NN treate radiation|NN relieve oxygen|NN therapy|NN research|NN complet area|NN
treatment|NN Ovarian cancer|Disease cause people|NN experience psychiatric difficulty|NN depression|NN
research|NN ongo determine counsel psychotherapy|NN help people|NN Ovarian cancer|Disease treatment|NN
indication|NN pelvic inflammatory disease|NN associate Ovarian cancer|Disease especially country|NN
due inflammatory process|NN present|NN pelvic inflammatory disease|NN clinical trial|NN
clinical trial|NN monitor fund governmental organization|NN test|NN treatment|NN option|NN see safe effective
include nih|NN clinical research|NN trial|NN national institute|NN health|NN learn clinical trial|NN national cancer|NN institute|NN search|NN clinical trial|NN national cancer|NN institute|NN national institute|NN health|NN clinical trial|NN conduct canada|NP
