free encyclopedia|NN jump|NN navigation|NN jump|NN search|NN Pancreatitis|Disease illu|NN pancrea|NN surround organ|NN general surgery|NN symptom|NN pain|NN upper abdomen|NN nausea|NN vomit|NN fever|NN fatty stool|NN complication|NN infection|NN bleed diabete|NN mellitus|NN duration|NN short|NP long term|NN cause|NN heavy alcohol|NN use|NN direct trauma|NN certain medication|NN mump|NN risk factor|NN smoke diagnostic method|NN blood|NN amylase|NN lipase|NN treatment|NN intravenous fluid|NN pain|NN medication|NN antibiotics|NN frequency|NN death|NN
Pancreatitis|Disease condition|NN characterize inflammation|NN pancrea|NN pancrea|NN large organ|NN stomach|NN produce digestive enzyme|NN number|NN hormone|NN main type|NN acute Pancreatitis|Disease chronic Pancreatitis|Disease sign|NN symptom|NN Pancreatitis|Disease include pain|NN upper abdomen|NN nausea|NN vomit pain|NN goe back|NN usually severe acute Pancreatitis|Disease fever|NN occur symptom|NN typically resolve day|NN chronic Pancreatitis|Disease weight|NN loss|NN fatty stool|NN occur complication|NN include infection|NN bleed diabete|NN mellitus|NN problem|NN organ|NN
common cause|NN acute Pancreatitis|Disease gallstone|NN block common bile|NN duct|NN pancreatic duct|NN join heavy alcohol|NN use|NN cause|NN include direct trauma|NN certain medication|NN infection|NN mump|NN chronic Pancreatitis|Disease develop result|NN acute Pancreatitis|Disease commonly due year|NN heavy alcohol|NN use|NN cause|NN include high level|NN blood|NN fat|NN high blood|NN calcium|NN medication|NN certain genetic disorder|NN cystic fibrosis|NN smoke|NN increase risk|NN acute chronic Pancreatitis|Disease diagnosis|NN acute Pancreatitis|Disease base threefold increase|NN blood|NN amylase|NN lipase|NN chronic Pancreatitis|Disease test|NN normal medical image|NN ultrasound|NN ct|NN scan|NN useful
acute Pancreatitis|Disease usually treate intravenous fluid|NN pain|NN medication|NN sometime antibiotics|NN typically eate|NN drink|NN disallow nasogastric tube|NN place stomach|NN procedure|NN known endoscopic retrograde|NN cholangiopancreatography|NN ercp|NN examine distal common bile|NN duct|NN remove gallstone|NN present gallstone|NN gallbladder|NN remove chronic Pancreatitis|Disease addition|NN above temporary feed|NN nasogastric tube|NN use provide adequate nutrition|NN long-term dietary change|NN pancreatic enzyme|NN replacement|NN require occasionally surgery|NN remove part|NN pancrea|NN
globally case|NN Pancreatitis|Disease occure result 132700 death|NN death|NN acute Pancreatitis|Disease occur people|NN year|NN new case|NN chronic Pancreatitis|Disease develop people|NN year|NN currently affect people|NN united|NP states|NP common men|NN women|NN chronic Pancreatitis|Disease start age|NN rare children|NN acute Pancreatitis|Disease describe autopsy|NN chronic Pancreatitis|Disease describe content|NN
sign|NN symptom|NN complication|NN cause|NN infection|NN diagnosis|NN treatment|NN mild acute Pancreatitis|Disease severe acute Pancreatitis|Disease epidemiology|NN society|NN culture|NN economics|NN animal|NN see reference|NN external link|NN
sign|NN symptom|NN
common symptom|NN Pancreatitis|Disease severe upper abdominal left upper quadrant|NN burn|NN pain|NN radiate back|NN nausea|NN vomit|NN worse eate|NN
physical examination|NN vary severity|NN presence|NN internal bleed
blood|NN pressure|NN elevate pain|NN decrease dehydration|NN bleed
heart|NN respiratory rate|NN elevate
abdomen|NN usually tender lesser degree|NN pain|NN
common abdominal disease|NN bowel|NN sound|NN reduce reflex bowel|NN paralysis|NN
fever|NN jaundice|NN present
chronic Pancreatitis|Disease lead diabete|NN pancreatic cancer|NN
weight|NN loss|NN occur lack|NN pancreatic enzyme|NN hinder digestion|NN
early complication|NN include shock|NN infection|NN systemic inflammatory response|NN syndrome|NN low blood|NN calcium|NN high blood|NN glucose|NN dehydration|NN
blood|NN loss|NN dehydration|NN fluid|NN leak|NN abdominal cavity|NN ascite|NN lead kidney|NN failure|NN
respiratory complication|NN severe
effusion|NN usually present
shallow breath|NN pain|NN lead lung|NN collapse|NN
pancreatic enzyme|NN attack lung|NN cause inflammation|NN
severe inflammation|NN lead intra-abdominal hypertension|NN abdominal compartment|NN syndrome|NN further impair renal respiratory function|NN potentially require management|NN open abdomen|NN relieve pressure|NN
late complication|NN include recurrent Pancreatitis|Disease development|NN pancreatic pseudocystscollection|NN pancreatic secretion|NN wall scar|NN tissue|NN
cause pain|NN become infect rupture|NN bleed block|NN bile|NN duct|NN cause|NN jaundice|NN migrate abdomen|NN
acute necrotize|NN Pancreatitis|Disease lead pancreatic abscess|NN collection|NN pus|NN cause necrosis|NN infection|NN
happen approximately case|NN case|NN involve pseudocyst|NN ga|NN pancrea|NN cause|NN
percent|NN case|NN Pancreatitis|Disease cause alcohol|NN gallstone|NN
single common cause|NN acute Pancreatitis|Disease alcohol|NN single common cause|NN chronic Pancreatitis|Disease level|NN greater important cause|NN
class|NN medication|NN associate acute Pancreatitis|Disease ace inhibitor|NN oral replacement|NN therapy|NN hrt|NN diuretics|NN therapy|NN acid|NN oral hypoglycemic|NN agent|NN
mechanism|NN drug|NN cause Pancreatitis|Disease known exactly possible direct toxic effect|NN pancrea|NN long-term accumulation|NN toxic metabolite|NN
meanwhile ace inhibitor|NN cause|NN angioedema|NN pancrea|NN accumulation|NN
birth|NN control|NN pill|NN hrt|NN cause|NN arterial thrombosis|NN pancrea|NN accumulation|NN fat hypertriglyceridemia|NN
diuretics direct toxic effect|NN pancrea|NN
meanwhile diuretics|NN cause|NN hypercalcemia risk|NN factor|NN pancreatic stone|NN
hiv|NP infection|NN cause person|NN likely get Pancreatitis|Disease
meanwhile drug|NN cause metabolic disturbance|NN predispose Pancreatitis|Disease
acid|NN direct toxic effect|NN pancrea|NN various oral hypoglycemic|NN agent|NN contribute Pancreatitis|Disease
peptide-1|NN strongly associate Pancreatitis|Disease promote inflammation|NN
atypical clozapine|NN cause Pancreatitis|Disease infection|NN
number|NN infectious agent|NN recognize cause|NN Pancreatitis|Disease
viruse|NN virus|NN hepatitis|NN b|NP herpes|NP simplex|NN virus|NN virus|NN bacteria|NN mycoplasma salmonella|NN parasite|NN cryptosporidium|NN
common cause|NN include trauma|NN autoimmune|NN disease|NN high blood|NN calcium|NN hypothermia|NN endoscopic retrograde|NN cholangiopancreatography|NN ercp|NN
common congenital malformation|NN pancrea|NN underlie recurrent case|NN
diabete|NN mellitus|NN type|NN associate 28-fold|NN higher risk|NN
common cause|NN include pancreatic cancer|NN pancreatic duct|NN stone|NN inflammation|NN small blood|NN vessel|NN pancrea|NN acute intermittent porphyria|NN erythropoietic|NN
inherit form|NN result|NN activation|NN trypsinogen|NN pancrea|NN lead
involve gene|NN include trypsin|NN code|NN spink1|NN code|NN trypsin|NN inhibitor|NN cystic fibrosis|NN transmembrane|NN conductance|NN regulator|NN
mnemonic getsmash|NN use remember common cause|NN Pancreatitis|Disease ttrauma|NN aautoimmune|NN Pancreatitis|Disease sting|NN hypothermia|NN retrograde|NN cholangiopancreatography|NN commonly azathioprine|NN acid|NN diagnosis|NN acute exudative|NN Pancreatitis|Disease ct|NN scan|NN pancreatic duct|NN stone|NN free intra-abdominal fluid|NN
differential diagnosis|NN Pancreatitis|Disease include limit cholecystitis|NN perforate peptic ulcer|NN bowel|NN infarction|NN small bowel|NN obstruction|NN hepatitis|NN mesenteric ischemia|NN
diagnosis|NN require follow criteria|NN
characteristic acute onset|NN epigastric vague abdominal pain|NN radiate back|NN see sign|NN symptom|NN serum|NN amylase|NN lipase|NN level|NN
time|NN upper limit|NN normal image|NN study|NN characteristic change|NN
ct|NN mry|NN abdominal ultrasound|NN endoscopic ultrasound|NN use diagnosis|NN
lipase|NN enzyme|NN produce pancrea|NN
elevation lipase|NN generally consider better indicator|NN Pancreatitis|Disease greater specificity|NN longer half|NN life|NN enzyme|NN elevate disease|NN state|NN
chronic Pancreatitis|Disease fecal pancreatic test|NN marker|NN exocrine pancreatic function|NN
additional test|NN useful evaluate chronic Pancreatitis|Disease include a1c immunoglobulin|NN rheumatoid factor|NN anti-nuclear antibody|NN
image|NN abdominal ultrasound|NN convenient simple non-invasive inexpensive sensitive specific Pancreatitis|Disease gallstone|NN image|NN modality|NN 2535|NN patient|NN view|NN pancrea|NN obstruct bowel|NN ga|NN make difficult evaluate
contrast-enhance ct|NN scan|NN usually perform hour|NN onset|NN pain|NN evaluate pancreatic necrosis|NN fluid|NN well predict severity|NN disease|NN
ct|NN scan|NN earlier falsely reassure
ercp|NP endoscopic ultrasound|NN use biliary cause|NN Pancreatitis|Disease suspect
treatment|NN Pancreatitis|Disease supportive depend severity|NN
generally suitable pain|NN control|NN
clinical study|NN suggest morphine|NN aggravate cause Pancreatitis|Disease cholecystitis|NN
treatment|NN acute Pancreatitis|Disease depend diagnosis|NN mild form|NN condition|NN cause complication|NN severe form|NN cause serious complication|NN
mild acute Pancreatitis|Disease
treatment|NN mild acute Pancreatitis|Disease successfully carry admission|NN general hospital|NN ward|NN
traditionally people|NN allow eat inflammation|NN resolve recent evidence|NN suggest early feed|NN safe improve outcome|NN
Pancreatitis|Disease cause lung|NN damage|NN affect normal lung|NN function|NN oxygen|NN occasionally deliver breath|NN tube|NN connect nose|NN
tube|NN remove day|NN clear condition|NN improve
result episode|NN acute Pancreatitis|Disease fluid|NN provide intravenously
use pain|NN
early feed|NN appear cause problem|NN result ability|NN leave hospital|NN sooner severe acute Pancreatitis|Disease
severe Pancreatitis|Disease cause organ|NN failure|NN necrosis|NN infect necrosis|NN abscess|NN
diagnose severe acute Pancreatitis|Disease people|NN need admit high dependency|NN unit|NN intensive care|NN unit|NN
likely level|NN fluid|NN body|NN drop significantly divert bodily fluid|NN nutrient|NN attempt|NN repair pancrea|NN
drop|NN fluid|NN level|NN lead reduction|NN volume|NN blood|NN body|NN known shock|NN
shock|NN life-threaten quickly starve body|NN oxygen-rich blood|NN need survive
avoid go shock|NN fluid|NN pump intravenously
oxygen|NN supply tube|NN attach nose|NN ventilation|NN equipment|NN use assist breath|NN
feed tube|NN use provide nutrient|NN combine appropriate analgesia|NN
mild acute Pancreatitis|Disease necessary treat underly causegallstone|NN discontinue medication|NN cessation|NN alcohol|NN
cause|NN gallstone|NN likely ercp|NN procedure|NN removal|NN gallbladder|NN recommend
gallbladder|NN remove hospital|NN admission|NN week|NN Pancreatitis|Disease onset|NN limit risk|NN recurrent Pancreatitis|Disease
cause|NN Pancreatitis|Disease alcohol|NN cessation|NN alcohol|NN consumption|NN treatment|NN alcohol|NN dependency|NN improve Pancreatitis|Disease
even underly cause|NN relate alcohol|NN consumption|NN doctor|NN recommend avoid month|NN cause further damage|NN pancrea|NN recovery|NN process|NN oral intake|NN especially fat|NN generally restrict initially early enteral feed|NN hour|NN show improve clinical outcome|NN electrolyte|NN replace intravenously
nutritional support|NN initiate tube|NN feed surpass portion|NN digestive tract|NN affect secret pancreatic enzyme|NN improvement|NN hour|NN treatment|NN
severe acute Pancreatitis|Disease mortality|NN rate|NN higher necrosis|NN pancrea|NN occure
score|NN system|NN use predict severity|NN attack|NN Pancreatitis|Disease
combine demographic laboratory|NN data|NN estimate|NN severity|NN probability|NN death|NN
example|NN include ranson|NP glasgow|NP
modify glasgow|NP criteria|NN suggest case|NN consider severe follow true
age|NN year|NN blood|NN level|NN oxygen|NN kpa|NN white blood|NN cell|NN calcium|NN mmollitre|NN dehydrogenase|NN aspartate transaminase|NN ast|NN 32glitre|NN mmollitre|NN
remember use mnemonic|NN
oxygen|NN kpa|NN age|NN white blood|NN cell|NN calcium|NN renal urea|NN lactate|NN dehydrogenase|NN aspartate|NN transaminase|NN ast|NN 32glitre sugar|NN glucose|NN
bisap score|NN blood|NN urea|NN nitrogen|NN level|NN impair mental status|NN systemic inflammatory response|NN syndrome|NN age|NN year|NN pleural effusion|NN validate similar prognostic score|NN system|NN epidemiology|NN
globally incidence|NN acute Pancreatitis|Disease case|NN people|NN
incidence|NN chronic Pancreatitis|Disease prevalence|NN 2642 case|NN Pancreatitis|Disease result 123000 death|NN death|NN society|NN culture|NN economics|NN
adult|NN united|NP kingdom|NP estimate average|NN total|NN direct indirect cost|NN chronic Pancreatitis|Disease roughly 79000 person|NN annual basis|NN acute recurrent Pancreatitis|Disease chronic Pancreatitis|Disease occur infrequently children|NN associate high healthcare|NN cost|NN due substantial disease|NN burden|NN estimate average|NN total|NN cost|NN treatment|NN children|NN condition|NN approximately 40500 annually animal|NN
fatty food|NN cause canine Pancreatitis|Disease dog|NN see
pancreatic insufficiency|NN
