free encyclopedia|NN jump|NN navigation|NN jump|NN search|NN Parkinson's disease|Disease redirect
medical journal|NN see disease|NN journal|NN
use|NN see disambiguation|NN
Parkinson's disease|Disease name|NN Parkinson's disease|Disease idiopathic Parkinson's disease|Disease Parkinson's disease|Disease Parkinson's disease|Disease Parkinson's disease|Disease sketche|NN front|NN right side|NN man|NN expressionless face|NN
stoop forward presumably difficulty|NN walk
illustration|NN Parkinson's disease|Disease william|NP richard|NP gowers|NP publish manual|NN disease|NN nervous system|NN symptom|NN shake rigidity|NN slowness|NN movement|NN difficulty|NN walk|NN complication|NN dementia|NN depression|NN anxiety|NN usual onset|NN age|NN cause|NN unknown risk|NN factor|NN pesticide|NN exposure|NN head|NN injury|NN diagnostic method|NN base symptom|NN differential diagnosis|NN dementia|NN lewy body|NN progressive palsy|NN essential tremor|NN use|NN treatment|NN surgery|NN dopamine|NN agonist|NN life|NN expectancy|NN year|NN frequency|NN death|NN
Parkinson's disease|Disease Parkinson's disease|Disease long-term degenerative disorder|NN central nervous system|NN mainly affect motor|NN system|NN disease|NN worsen symptom|NN become common symptom|NN usually emerge slowly early disease|NN obvious symptom|NN shake rigidity|NN slowness|NN movement|NN difficulty|NN walk|NN think|NN behavioral|NN problem|NN occur dementia|NN become common advance stage|NN disease|NN depression|NN anxiety|NN common occure people|NN Parkinson's disease|Disease symptom|NN include sensory sleep|NN emotional problem|NN main motor|NN symptom|NN collectively call parkinsonian syndrome|NN
cause|NN Parkinson's disease|Disease unknown believe involve genetic environmental factor|NN family|NN member|NN affect likely get disease|NN increase risk|NN people|NN expose certain pesticide|NN prior head|NN injury|NN reduce risk|NN tobacco|NN smoker|NN drink coffee|NN tea|NN motor|NN symptom|NN disease|NN result|NN death|NN cell|NN substantia nigra|NN region|NN midbrain|NN result|NN dopamine|NN region|NN brain|NN cause|NN cell|NN death|NN poorly understood involve build-up|NN protein|NN lewy body|NN neuron|NN diagnosis|NN typical case|NN mainly base symptom|NN test|NN use rule|NN disease|NN
cure|NN Parkinson's disease|Disease treatment|NN aim improve symptom|NN initial treatment|NN typically antiparkinson medication|NN l-dopa|NN follow dopamine|NN agonist|NN become effective disease|NN progress neuron|NN continue lost medication|NN become effective time|NN produce complication|NN mark involuntary writh movement|NN diet|NN form|NN rehabilitation|NN show effectiveness|NN improve symptom|NN surgery|NN place|NN deep brain|NN stimulation|NN use reduce motor|NN symptom|NN severe case|NN drug|NN ineffective evidence|NN treatment|NN non-movement-relate symptom|NN Parkinson's disease|Disease sleep|NN disturbance|NN emotional problem|NN strong
Parkinson's disease|Disease affect people|NN result death|NN globally Parkinson's disease|Disease typically occur people|NN age|NN percent|NN affect male|NN affect female|NN ratio|NN seen people|NN age|NN call Parkinson's disease|Disease average life|NN expectancy|NN diagnosis|NN year|NN disease|NN name english doctor|NN james|NP parkinson|NP publish detail description|NN essay|NN Parkinson's disease|Disease public awareness|NN campaign|NN include world|NN day|NN birthday|NN james|NP parkinson|NP april|NP use|NN red tulip|NN symbol|NN disease|NN people|NN parkinson|NN increase publics|NN awareness|NN condition|NN include actor|NN michael|NP j|NP
fox|NP olympic cyclist|NN davis|NP professional boxer|NN muhammad|NP ali|NP actor|NN alan|NP alda|NP content|NN
classification|NN sign|NN symptom|NN motor|NN cause|NN environmental factor|NN genetics|NN brain|NN cell|NN death|NN diagnosis|NN image|NN differential diagnosis|NN prevention|NN management|NN surgery|NN rehabilitation|NN care|NN epidemiology|NN history|NN society|NN culture|NN cost|NN advocacy|NN notable case|NN research|NN animal|NN model|NN gene|NP therapy|NN neuroprotective|NN treatment|NN therapy|NN reference|NN external link|NN
movement|NN difficulty|NN found Parkinson's disease|Disease call define slowness|NN initiate voluntary movement|NN progressive reduction|NN speed|NN range|NN repetitive action|NN voluntary finger-tap|NN combination|NN physical sign|NN muscular rigidity|NN tremor|NN rest|NN postural instability|NN
number|NN different disorder|NN type|NN movement|NN issue|NN
Parkinson's disease|Disease common form|NN parkinsonism|NN sometime call Parkinson's disease|Disease mean|NN identifiable cause|NN cause|NN parkinsonism|NN include toxin|NN infection|NN side|NN effect|NN drug|NN metabolic derangement|NN brain|NN lesion|NN stroke|NN
neurodegenerative disorder|NN present parkinsonism|NN sometime refer atypical parkinson|NP syndrome|NN illness|NN parkinsonism|NN feature|NN distinguish Parkinson's disease|Disease
include multiple system|NN atrophy|NN progressive supranuclear|NN palsy|NN degeneration|NN dementia|NN lewy body|NN
scientist|NN sometime refer disease|NN synucleinopathy due|NN abnormal accumulation|NN protein|NN brain|NN distinguish neurodegenerative disease|NN alzheimers|NP disease|NN brain|NN accumulate tau|NN protein|NN considerable clinical pathological overlap|NN exist tauopathy|NN synucleinopathy|NN
contrast|NN Parkinson's disease|Disease alzheimers|NP disease|NN present commonly memory|NN loss|NN cardinal sign|NN Parkinson's disease|Disease slowness|NN tremor|NN stiffness|NN postural instability|NN normal feature|NN alzheimers|NP
dementia|NN lewy body|NN close pathological similarity|NN Parkinson's disease|Disease especially subset|NN Parkinson's disease|Disease case|NN dementia|NN known Parkinson's disease|Disease dementia|NN
relationship|NN Parkinson's disease|Disease complex incompletely understood represent part|NN continuum|NN variable distinguish clinical pathological feature|NN prove separate disease|NN sign|NN symptom|NN black white picture|NN male|NN Parkinson's disease|Disease stoop|NN forward walk
view left side|NN chair|NN
man|NN Parkinson's disease|Disease display|NN flex walk|NN posture|NN picture french signature|NN read catherine|NP handwrit|NN person|NN affect Parkinson's disease|Disease main article|NN sign|NN symptom|NN Parkinson's disease|Disease
recognizable symptom|NN Parkinson's disease|Disease movement|NN motor|NN relate symptom|NN include autonomic dysfunction|NN problem|NN mood|NN cognition|NN behavior|NN thought|NN alteration|NN sensory especially alter sense|NN smell|NN sleep|NN difficulty|NN common
non-motor symptom|NN present time|NN diagnosis|NN motor|NN further information|NN gait|NN
motor|NN symptom|NN consider cardinal Parkinson's disease|Disease tremor|NN slowness|NN movement|NN rigidity|NN postural instability|NN
common present sign|NN coarse slow tremor|NN hand|NN rest|NN disappear voluntary movement|NN affect arm|NN deeper stage|NN sleep|NN typically appear hand|NN eventually affect hand|NN disease|NN progress frequency|NN Parkinson's disease|Disease tremor|NN hertz|NN cycle|NN second|NN
feature|NN tremor|NN pill-rol tendency|NN index|NN finger|NN thumb|NN touch|NN perform together circular movement|NN term|NN derive similarity|NN movement|NN people|NN Parkinson's disease|Disease early pharmaceutical technique|NN manually make pill|NN
slowness|NN movement|NN found case|NN Parkinson's disease|Disease due disturbance|NN motor|NN plan|NN movement|NN initiation|NN associate difficulty|NN whole course|NN movement|NN process|NN plan|NN initiation|NN execution|NN movement|NN
performance|NN sequential simultaneous movement|NN impair
handicap symptom|NN disease|NN lead difficulty|NN everyday task|NN dress|NN feed|NN bath|NN
lead particular difficulty|NN carry independent motor|NN activity|NN time|NN made worse emotional stress|NN concurrent illness|NN
paradoxically patient|NN Parkinson's disease|Disease ride bicycle|NN climb|NN stair|NN easily walk|NN level|NN
physician|NN readily notice formal assessment|NN require patient|NN repetitive movement|NN finger|NN feet|NN
stiffness|NN resistance|NN limb|NN movement|NN cause increase muscle|NN tone|NN excessive continuous contraction|NN muscle|NN parkinsonism|NN rigidity|NN uniform rigidity|NN cogwheel rigidity|NN combination|NN tremor|NN increase tone|NN consider origin|NN rigidity|NN rigidity|NN associate joint pain|NN pain|NN frequent initial manifestation|NN disease|NN early stage|NN Parkinson's disease|Disease rigidity|NN asymmetrical tend affect neck|NN shoulder|NN muscle|NN prior muscle|NN face|NN extremity|NN progression|NN disease|NN rigidity|NN typically affect whole body|NN reduce ability|NN move
instability|NN typical later stage|NN disease|NN lead impair balance|NN frequent fall|NN secondarily bone|NN fracture|NN loss|NN confidence|NN reduce mobility|NN instability|NN absent initial stage|NN especially younger people|NN especially prior development|NN bilateral symptom|NN people|NN diagnose Parkinson's disease|Disease experience fall|NN fall|NN weekly number|NN fall|NN relate severity|NN Parkinson's disease|Disease
recognize motor|NN sign|NN symptom|NN include gait|NN posture|NN disturbance|NN rapid shuffle|NN step|NN forward-flex posture|NN walk flex arm|NN swing|NN
freez gait|NN brief arrest|NN feet|NN seem get stuck floor|NN especially turn|NN chang direction|NN slure monotonous quiet voice|NN mask-like facial expression|NN handwrit|NN get smaller smaller common sign|NN
Parkinson's disease|Disease cause disturbance|NN range mild severe
include disorder|NN cognition|NN mood|NN behavior|NN thought|NN
cognitive disturbance|NN occur early stage|NN disease|NN sometime prior diagnosis|NN increase|NN prevalence|NN duration|NN disease|NN common cognitive deficit|NN Parkinson's disease|Disease executive|NN dysfunction|NN include problem|NN plan cognitive flexibility|NN abstract think|NN rule|NN acquisition|NN inhibit inappropriate action|NN initiate appropriate action|NN work memory|NN control|NN attention|NN cognitive difficulty|NN include slow cognitive process|NN speed|NN impair recal|NN impair perception|NN estimation|NN time|NN nevertheless improvement|NN appear recal|NN aid cue|NN difficulty|NN part|NN disease|NN seen example|NN individual|NN ask perform test|NN facial recognition|NN perception|NN orientation|NN drawn line|NN
person|NN Parkinson's disease|Disease time|NN risk|NN dementia|NN compare general population|NN people|NN Parkinson's disease|Disease Parkinson's disease|Disease dementia|NN prevalence|NN dementia|NN increase|NN age|NN lesser degree|NN duration|NN disease|NN dementia|NN associate reduce quality|NN life|NN people|NN Parkinson's disease|Disease caregiver increase mortality|NN higher probability|NN need nurse|NN home|NN care|NN
control|NN disorder|NN pathological gamble|NN compulsive sexual behavior|NN binge|NN eate compulsive shop|NN reckless generosity|NN cause medication|NN particularly orally active dopamine|NN agonist|NN
dopamine|NN syndrome|NN want medication|NN lead overusage|NN rare complication|NN use|NN
mood|NN alteration|NN common Parkinson's disease|Disease cognitive impairment|NN general population|NN usually present Parkinson's disease|Disease dementia|NN
frequent mood|NN difficulty|NN depression|NN apathy|NN anxiety|NN establish diagnosis|NN depression|NN complicate fact|NN body|NN language|NN depression|NN masquerade Parkinson's disease|Disease sad expressionless anxious face|NN hang|NN dog|NN appearance|NN slow movement|NN monotonous speech|NN
people|NN Parkinson's disease|Disease experience symptom|NN anxiety|NN rang generalize anxiety|NN disorder|NN social phobia|NN panic|NN disorder|NN obsessive compulsive disorder|NN
contribute impair quality|NN life|NN increase severity|NN motor|NN symptom|NN fluctuation|NN freez episode|NN
pund complicate repetitive aimless stereotype behavior|NN occur hour|NN disturbance|NN cause medication|NN
delusion|NN occur approximately people|NN Parkinson's disease|Disease course|NN illness|NN herald emergence|NN dementia|NN
range|NN minor hallucination|NN sense|NN passage|NN quickly pass person|NN sense|NN presence|NN perception|NN stand|NN side|NN person|NN full blown vivid form visual hallucination|NN paranoid ideation|NN
hallucination|NN uncommon Parkinson's disease|Disease rarely describe voice|NN
believe psychosis|NN integral part|NN disease|NN
psychosis|NN delusion|NN associate delirium|NN recognize complication|NN drug|NN treatment|NN cause urinary tract|NN infection|NN frequently occur fragile elderly drug|NN infection|NN factor|NN underly brain|NN pathology|NN change|NN neurotransmitter|NN receptor|NN eg acetylcholine|NN serotonin|NN thought play role|NN psychosis|NN Parkinson's disease|Disease
addition|NN neuropsychiatric|NN motor|NN symptom|NN Parkinson's disease|Disease impair function|NN
sleep|NN disorder|NN feature|NN disease|NN worsen medication|NN symptom|NN manifest daytime|NN drowsiness|NN sudden sleep|NN attack|NN resemble narcolepsy disturbance|NN rem|NN sleep|NN insomnia|NN rem|NN behavior|NN disorder|NN patient|NN act dream|NN sometime injure bed|NN partner|NN begin year|NN development|NN motor|NN cognitive feature|NN Parkinson's disease|Disease dlb|NN
alteration|NN autonomic nervous system|NN lead hypotension|NN low blood|NN pressure|NN stand oily skin|NN excessive sweate|NN urinary incontinence|NN alter sexual function|NN constipation|NN impair stomach|NN empty gastric dysmotility|NN severe cause discomfort|NN even endanger health|NN change|NN perception|NN include impair sense|NN smell|NN disturb vision|NN pain|NN tingle|NN numbness|NN symptom|NN occur year|NN diagnosis|NN disease|NN cause|NN main article|NN cause|NN Parkinson's disease|Disease
risk|NN factor|NN propose sometime relation|NN theory|NN possible mechanism|NN disease|NN none conclusively proven frequently replicate relationship|NN increase risk|NN expose pesticide|NN reduce risk|NN smoker|NN possible link|NN Parkinson's disease|Disease h|NP pylory|NN infection|NN prevent absorption|NN drug|NN environmental factor|NN
exposure|NN pesticide|NN history|NN head|NN injury|NN link Parkinson's disease|Disease Parkinson's disease|Disease risk|NN modest
smoke cigarette|NN drink beverage|NN associate small increase|NN risk|NN develop Parkinson's disease|Disease
low concentration|NN urate|NN blood|NN serum|NN associate increase risk|NN Parkinson's disease|Disease genetics|NN parkin|NP crystal|NN structure|NN
research|NN indicate Parkinson's disease|Disease product|NN complex interaction|NN genetic environmental factor|NN individual|NN Parkinson's disease|Disease first-degree relative|NN disease|NN people|NN Parkinson's disease|Disease known form|NN disease|NN occur mutation|NN specific gene|NN gene|NN mutation|NN lead disease|NN susceptibility|NN factor|NN put individual|NN increase risk|NN combination|NN risk|NN factor|NN affect age|NN onset|NN severity|NN progression|NN autosomal|NN dominant autosomal recessive gene|NN mutation|NN implicate development|NN Parkinson's disease|Disease lrrk2park8|NN pink1|NN eif4g1 dnajc13|NN
people|NN Parkinson's disease|Disease mutation|NN gba1 gene|NN mutation|NN present unaffect population|NN
risk|NN develop Parkinson's disease|Disease increase fold|NN mutation|NN present
Parkinson's disease|Disease associate mutation|NN clinical feature|NN earlier age|NN onset|NN rapid cognitive motor decline|NN
gene|NN mutation|NN important Parkinson's disease|Disease protein|NN gene|NN encode main component|NN lewy body|NN accumulate brain|NN people|NN Parkinson's disease|Disease mutation|NN gene|NN lrrk2|NN found risk|NN factor|NN sporadic non-familial|NN Parkinson's disease|Disease mutation|NN gene|NN common known cause|NN familial sporadic Parkinson's disease|Disease account|NN approximately individual|NN family|NN history|NN disease|NN sporadic case|NN mutation|NN gba|NN present greatest genetic risk|NN develop disease|NN
parkinson-relate gene|NN involve function|NN lysosome|NN organelle|NN digest cellular waste|NN product|NN
suggest case|NN Parkinson's disease|Disease cause lysosomal disorder|NN reduce ability|NN cell|NN break
autosomal dominant form|NN associate mutation|NN lrp10 gene|NN brain|NN cell|NN stain blue
largest neurone|NN approximately circular form|NN brown circular body|NN
brown body|NN diameter|NN cell|NN appear
lewy body|NN stain brown brain|NN cell|NN substantia nigra|NN Parkinson's disease|Disease
brown colour|NN positive immunohistochemistry|NN stain|NN
main article|NN pathophysiology|NN Parkinson's disease|Disease
main pathological characteristics|NN Parkinson's disease|Disease cell|NN death|NN brain|NN basal ganglia|NN affect dopamine|NN secret neuron|NN substantia nigra|NN par|NN end|NN life|NN presence|NN lewy body|NN accumulation|NN protein|NN remain neuron|NN
loss|NN neuron|NN accompany death|NN star-shap glial cell|NN significant increase|NN number|NN type|NN glial cell|NN substantia nigra|NN composite image|NN top row|NN refer caption|NN row|NN refer b|NP
top|NN show mid-line|NN plane|NN brainstem|NN cerebellum|NN
circle|NN superimpose brainstem|NN arrow|NN link bottom|NN top|NN continue upward forward frontal lobe|NN brain|NN
line|NN text|NN accompany circle|NN lower
motor|NN middle|NN
gain|NN set|NN upper
line|NN text|NN say
image|NN bottom|NN composite magnetic resonance|NN image|NN mry|NN scan sagittal|NN transverse|NN centr brain|NN coordinate|NN z-49|NN
color blob|NN mark|NN volume|NN reduction|NN cover brainstem|NN
schematic initial progression|NN body|NN deposit|NN stage|NN Parkinson's disease|Disease propose braak|NN colleague|NN area|NN significant brain|NN volume|NN reduction|NN initial Parkinson's disease|Disease compare group|NN participant|NN disease|NN neuroimage study|NN conclude brainstem|NN damage|NN identifiable stage|NN Parkinson's disease|Disease neuropathology|NN
major pathway|NN brain|NN connect brain|NN area|NN basal ganglia|NN
known motor|NN associative limbic orbitofrontal circuit|NN name|NN indicate main projection|NN area|NN circuit|NN affect Parkinson's disease|Disease disruption|NN explain symptom|NN disease|NN circuit|NN involve wide variety|NN function|NN movement|NN attention|NN learn|NN motor|NN circuit|NN examine intensively
particular conceptual model|NN motor|NN circuit|NN alteration|NN Parkinson's disease|Disease great influence|NN limitation|NN point led modification|NN model|NN basal ganglia|NN normally exert constant inhibitory influence|NN wide range|NN motor|NN system|NN prevent becom active inappropriate time|NN
decision|NN made perform particular action|NN inhibition|NN reduce require motor|NN system|NN thereby release activation|NN
act facilitate release|NN inhibition|NN high level|NN dopamine|NN function|NN tend promote motor|NN activity|NN low level|NN dopamine|NN function|NN occur Parkinson's disease|Disease demand|NN greater exertion|NN effort|NN give movement|NN
net effect|NN dopamine|NN depletion|NN produce overal reduction|NN motor|NN output|NN drug|NN use treat Parkinson's disease|Disease conversely produce excessive dopamine|NN activity|NN allow motor|NN system|NN activate inappropriate time|NN thereby produce brain|NN cell|NN death|NN
speculation|NN mechanism|NN brain|NN cell|NN lost mechanism|NN consist abnormal accumulation|NN protein|NN bound ubiquitin|NN damage cell|NN
insoluble protein|NN accumulate neurone|NN form inclusion|NN call body|NN braak|NN stage classification|NN disease|NN base pathological find|NN propose braak|NN body|NN appear olfactory bulb|NN medulla|NN tegmentum individual|NN stage|NN asymptomatic early non-motor symptom|NN loss|NN sense|NN smell|NN sleep|NN automatic dysfunction|NN
disease|NN progress body|NN develop substantia nigra|NN area|NN midbrain|NN basal forebrain|NN finally neocortex|NN brain|NN site|NN main place|NN neuronal degeneration|NN Parkinson's disease|Disease lewy body|NN cause cell|NN death|NN protective abnormal protein|NN sequester wall
form|NN eg oligomer|NN aggregate lewy body|NN neurite|NN actually toxic form|NN protein|NN people|NN dementia|NN generalize presence|NN lewy body|NN common cortical area|NN
tangle|NN senile plaque|NN characteristic|NN alzheimers|NP disease|NN common person|NN dement
cell-death|NN mechanism|NN include proteasomal lysosomal system|NN dysfunction|NN reduce mitochondrial activity|NN iron|NN accumulation|NN substantia nigra|NN typically observe conjunction|NN protein|NN inclusion|NN
relate oxidative stress|NN protein|NN aggregation|NN neuronal death|NN mechanism|NN fully understood diagnosis|NN
physician|NN initially assess Parkinson's disease|Disease careful medical history|NN neurological examination|NN people|NN give levodopa result improvement|NN motor|NN impairment|NN help confirm Parkinson's disease|Disease diagnosis|NN
find|NN lewy body|NN midbrain|NN autopsy|NN usually consider final proof|NN person|NN Parkinson's disease|Disease
clinical course|NN illness|NN time|NN reveal Parkinson's disease|Disease require clinical presentation|NN periodically review confirm accuracy|NN diagnosis|NN
cause|NN secondarily produce stroke|NN drug|NN parkinson|NP syndrome|NN progressive supranuclear|NN palsy|NN multiple system|NN atrophy|NN rule anti-parkinson medication|NN typically effective control symptom|NN parkinson|NP syndrome|NN faster progression|NN rate|NN early cognitive dysfunction|NN postural instability|NN minimal tremor|NN symmetry|NN onset|NN indicate parkinson|NP plus|NN disease|NN Parkinson's disease|Disease genetic form|NN autosomal dominant recessive pattern|NN inheritance|NN sometime refer familial Parkinson's disease|Disease familial parkinsonism|NN
medical organization|NN create diagnostic criteria|NN ease|NN standardize diagnostic process|NN especially early stage|NN disease|NN
widely known criteria|NN come uk|NP queen|NN square|NN brain|NN bank|NN neurological disorder|NN
national institute|NN neurological disorder|NN stroke|NN
queen|NN square|NN brain|NN bank|NN criteria|NN require slowness|NN movement|NN rigidity|NN rest|NN tremor|NN postural instability|NN
possible cause|NN symptom|NN need rule
finally follow supportive feature|NN require onset|NN evolution|NN unilateral onset|NN tremor|NN rest|NN progression|NN time|NN asymmetry|NN motor|NN symptom|NN response|NN levodopa year|NN clinical course|NN year|NN appearance|NN dyskinesia|NN induce intake|NN excessive levodopa|NN
Parkinson's disease|Disease diagnose|NN check autopsy|NN movement|NN disorder|NN expert|NN found average|NN accurate initial assessment|NN accurate refine diagnosis|NN follow-up examination|NN
clinical diagnose|NN perform mainly nonexpert|NN check autopsy|NN average|NN accuracy|NN
overal Parkinson's disease|Disease diagnose|NN accurate diagnose|NN use brain|NN bank|NN criteria|NN accurate
task|NN force|NN international parkinson|NP movement|NN disorder|NN society|NN propose diagnostic criteria|NN disease|NN well research|NN criteria|NN diagnosis|NN disease|NN require validation|NN establish criteria|NN image|NN
compute tomography|NN ct|NN scan|NN people|NN Parkinson's disease|Disease usually appear normal mry|NN become accurate diagnosis|NN disease|NN time|NN specifically sequence|NN magnetic field|NN strength|NN demonstrate absence|NN characteristic swallow|NN tail|NN image|NN pattern|NN dorsolateral|NN nigra|NN meta-analysis|NN absence|NN pattern|NN highly sensitive specific disease|NN diffusion|NN mry|NN show potential|NN distinguish Parkinson's disease|Disease parkinson|NP syndrome|NN diagnostic value|NN investigation|NN ct|NN mry|NN use rule|NN disease|NN secondary cause|NN commonly encephalitis|NN chronic ischemic|NN insult|NN well frequent entity|NN basal ganglia|NN
metabolic activity|NN dopamine|NN transporter|NN basal ganglia|NN directly measure pet|NN spect|NN scan|NN datscan|NN common proprietary version|NN study|NN
show high agreement|NN clinical diagnose|NN reduce dopamine-relate|NN activity|NN basal ganglia|NN help exclude drug-induce parkinsonism|NN
find|NN entirely specific seen Parkinson's disease|Disease parkinson-plus|NN disorder|NN united|NP states|NP fda|NP approve distinguish disease|NN parkinsonian|NN syndrome|NN essential tremor|NN differential diagnosis|NN
condition|NN similar presentation|NN Parkinson's disease|Disease include
arthritis|NP syndrome|NN dementia|NN lewy body|NN depression|NN drug|NN induce fragile x-associate|NN syndrome|NN dementia|NN parkinsonism|NN link chromosome|NN disease|NN basal ganglia|NN multiple system|NN atrophy|NN brain|NN iron|NN accumulation|NN obsessional slowness|NN progressive supranuclear|NN palsy|NN wilsons|NP disease|NN vascular|NN
exercise middle age|NN reduce risk|NN Parkinson's disease|Disease later life|NN caffeine|NN appear protective greater decrease|NN risk|NN occure larger intake|NN caffeinate beverage|NN coffee|NN people|NN smoke cigarette|NN use|NN smokeless tobacco|NN likely non-smoker|NN develop Parkinson's disease|Disease use tobacco|NN likely develop Parkinson's disease|Disease
known underly effect|NN
tobacco|NN use|NN actually protect Parkinson's disease|Disease unknown factor|NN increase risk|NN Parkinson's disease|Disease cause aversion|NN tobacco|NN make easier quit use tobacco|NN
antioxidant vitamin|NN propose protect disease|NN result|NN study|NN contradictory positive effect|NN proven result|NN fat|NN fatty acid|NN contradictory various study|NN report protective effect|NN effect|NN effect|NN preliminary indication|NN use|NN anti-inflammatory drug|NN calcium|NN channel|NN blocker|NN protective meta-analysis|NN found anti-inflammatory drug|NN apart aspirin|NN associate percent|NN higher long-term regular user|NN reduction|NN incidence|NN development|NN Parkinson's disease|Disease management|NN main article|NN management|NN Parkinson's disease|Disease pharmacological treatment|NN Parkinson's disease|Disease
cure|NN Parkinson's disease|Disease medication|NN surgery|NN physical treatment|NN provide relief|NN effective treatment|NN available neurological disorder|NN alzheimers|NP disease|NN motor|NN neuron|NN disease|NN parkinson|NP syndrome|NN
main family|NN drug|NN useful treate motor|NN symptom|NN levodopa alway combine dopa|NN inhibitor|NN sometime comt inhibitor|NN dopamine|NN agonist|NN mao-b inhibitor|NN
stage|NN disease|NN age|NN disease|NN onset|NN determine group|NN useful
stage|NN Parkinson's disease|Disease give stage|NN use identify early stage|NN later stage|NN late stage|NN
initial stage|NN disability|NN develop require pharmacological treatment|NN follow later stage|NN associate development|NN complication|NN relate usage|NN stage|NN symptom|NN unrelate dopamine|NN deficiency|NN treatment|NN predominate
treatment|NN stage|NN aim|NN optimal trade-off|NN symptom|NN control|NN treatment|NN side-effect|NN
start|NN treatment|NN postpon initially use medication|NN inhibitor|NN dopamine|NN agonist|NN instead hope|NN delay onset|NN complication|NN due use|NN effective treatment|NN motor|NN symptom|NN Parkinson's disease|Disease delay patient|NN quality|NN life|NN impair
correlate strongly duration|NN severity|NN disease|NN duration|NN treatment|NN delay therapy|NN provide longer dyskinesia-free time|NN early use|NN
later stage|NN aim|NN reduce Parkinson's disease|Disease symptom|NN control fluctuation|NN effect|NN medication|NN
sudden withdrawal|NN medication|NN overuse|NN manage oral medication|NN control|NN symptom|NN surgery|NN deep brain|NN stimulation|NN subcutaneous wake|NN day|NN infusion|NN enteral dopa|NN pump|NN uselate stage|NN Parkinson's disease|Disease present challenge|NN require variety|NN treatment|NN psychiatric symptom|NN particularly depression|NN hypotension|NN bladder|NN dysfunction|NN dysfunction|NN final stage|NN disease|NN palliative care|NN provide improve quality|NN life|NN
motor|NN symptom|NN Parkinson's disease|Disease result|NN reduce dopamine|NN production|NN brain|NN basal ganglia|NN
cross blood-brain barrier|NN taken medicine|NN boost brain|NN deplet level|NN dopamine|NN
precursor|NN dopamine|NN pass brain|NN readily convert dopamine|NN administration|NN temporarily diminishe motor|NN symptom|NN Parkinson's disease|Disease
widely use Parkinson's disease|Disease treatment|NN year|NN
cross|NN bloodbrain barrier|NN
remainder|NN metabolize dopamine|NN elsewhere body|NN cause variety|NN side|NN effect|NN nausea|NN vomit|NN hypotension|NN dopa decarboxylase inhibitor|NN cross blood-brain barrier|NN inhibit conversion|NN levodopa|NN dopamine|NN brain|NN reduce side|NN effect|NN improve availability|NN levodopa|NN passage|NN brain|NN
drug|NN usually taken along combine levodopa|NN pill|NN
lead long term|NN development|NN complication|NN involuntary movement|NN call fluctuation|NN effectiveness|NN medication|NN fluctuation|NN occur person|NN cycle phase|NN good response|NN medication|NN reduce Parkinson's disease|Disease symptom|NN state|NN phase|NN poor response|NN medication|NN significant Parkinson's disease|Disease symptom|NN state|NN use lower dose|NN levodopa|NN reduce risk|NN severity|NN levodopa-induce complication|NN strategy|NN reduce dyskinesia|NN fluctuation|NN withdraw medication|NN time|NN
discourage bring dangerous side|NN effect|NN malignant syndrome|NN people|NN Parkinson's disease|Disease eventually need later develop fluctuation|NN dyskinesia|NN
older controlled-release|NN preparation|NN poor unreliable absorption|NN bioavailability|NN demonstrate improve control|NN Parkinson's disease|Disease motor|NN symptom|NN reduction|NN levodopa-relate complication|NN compare immediate release|NN preparation|NN
newer extended-release|NN preparation|NN seem effective reduce fluctuation|NN patient|NN problem|NN persist
intestinal infusion|NN duodopa|NN result strike improvement|NN fluctuation|NN compare oral levodopa|NN fluctuation|NN due insufficient uptake|NN cause
oral|NN longer act formulation|NN study|NN mode|NN delivery|NN inhal develop inhibitor|NN
inhibit activity|NN enzyme|NN degrade dopamine|NN use complement|NN usefulness|NN limit possible complication|NN liver|NN damage|NN similarly effective drug|NN entacapone|NN show cause significant alteration|NN liver|NN function|NN license preparation|NN entacapone|NN contain alone combination|NN carbidopa|NN levodopa|NN agonist|NN
dopamine|NN agonist|NN bind dopamine|NN receptor|NN brain|NN similar effect|NN levodopa initially use complementary therapy|NN levodopa individual|NN experience levodopa complication|NN on-off fluctuation|NN dyskinesia mainly use therapy|NN motor|NN symptom|NN Parkinson's disease|Disease aim|NN delay initiation|NN therapy|NN delay onset|NN levodopa complication|NN agonist|NN include pergolide|NN piribedil cabergoline|NN
dopamine|NN agonist|NN effective levodopa control Parkinson's disease|Disease motor|NN symptom|NN usually effective manage symptom|NN year|NN treatment|NN dopamine|NN agonist|NN rare younger people|NN Parkinson's disease|Disease along complication|NN become common older age|NN onset|NN dopamine|NN agonist|NN prefer initial treatment|NN younger onset|NN Parkinson's disease|Disease prefer older onset|NN Parkinson's disease|Disease
agonist|NN produce significant usually mild side|NN effect|NN drowsiness|NN hallucination|NN insomnia|NN nausea|NN constipation|NN sometime side|NN effect|NN appear even minimal clinically effective dose|NN lead physician|NN search|NN different drug|NN relate impulse|NN control|NN disorder|NN compulsive sexual activity|NN eate|NN gamble|NN shop|NN even strongly tend expensive
apomorphine non-orally administer dopamine|NN agonist|NN use reduce period|NN dyskinesia|NN late Parkinson's disease|Disease administer intermittent injection|NN continuous subcutaneous infusion|NN secondary effect|NN confusion|NN hallucination|NN common individual|NN receive treatment|NN closely monitor dopamine|NN agonist|NN administer skin|NN patche|NN rotigotine useful people|NN initial stage|NN possibly control|NN state|NN advance state|NN inhibitor|NN
inhibitor|NN selegiline|NN increase|NN amount|NN dopamine|NN basal ganglia|NN inhibit activity|NN oxidase|NN enzyme|NN break dopamine|NN dopamine|NN agonist|NN use|NN delay commencement|NN therapy|NN early disease|NN mao-b|NN inhibitor|NN produce adverse effect|NN effective levodopa control Parkinson's disease|Disease motor|NN symptom|NN
study|NN effectiveness|NN advance stage|NN result|NN suggest useful reduce fluctuation|NN period|NN initial study|NN indicate selegiline|NN combination|NN levodopa|NP increase risk|NN death|NN later drug|NN main article|NN medication|NN
drug|NN useful treatment|NN motor|NN symptom|NN
evidence|NN support lack quality|NN choice|NN treatment|NN addition|NN motor|NN symptom|NN Parkinson's disease|Disease accompany diverse range|NN symptom|NN
number|NN drug|NN use treat problem|NN example|NN use|NN quetiapine|NN psychosis|NN inhibitor|NN dementia|NN modafinil|NN daytime|NN sleepiness|NN pimavanserin|NN approve management|NN Parkinson's disease|Disease psychosis|NN
reduce physical fatigue|NN Parkinson's disease|Disease surgery|NN placement|NN electrode|NN brain|NN
head|NN stabilise frame|NN surgery|NN
treate motor|NN symptom|NN surgery|NN common practice|NN discovery|NN levodopa|NN number|NN operation|NN decline study|NN past|NN decade|NN led great improvement|NN surgical technique|NN surgery|NN use people|NN advance Parkinson's disease|Disease drug|NN therapy|NN longer sufficient surgery|NN Parkinson's disease|Disease divide main group|NN deep brain|NN stimulation|NN dbs|NP
target|NN area|NN dbs|NP lesion|NN include thalamus|NN globus|NN subthalamic nucleus|NN deep brain|NN stimulation|NN commonly use surgical treatment|NN develop alim|NP louis|NP
involve implantation|NN medical device|NN call neurostimulator|NN send electrical impulse|NN specific part|NN brain|NN
dbs|NP recommend people|NN Parkinson's disease|Disease motor|NN fluctuation|NN tremor|NN inadequately control medication|NN intolerant medication|NN long severe neuropsychiatric problem|NN common surgical therapy|NN involve intentional formation|NN lesion|NN suppress specific subcortical area|NN
example|NN involve surgical destruction|NN globus pallidus|NN control|NN
area|NN brain|NN treate neural stimulator|NN Parkinson's disease|Disease globus|NN thalamus|NN nucleus|NN pedunculopontine nucleus|NN
dbs|NP globus pallidus|NN improve motor|NN function|NN dbs|NP thalamic|NP dbs|NP improve tremor|NN little effect|NN bradykinesia|NN rigidity|NN
dbs|NP subthalamic nucleus|NN usually avoid history|NN depression|NN impairment|NN present
dbs|NP subthalamic nucleus|NN associate reduction|NN medication|NN
nucleus|NN dbs|NP remain experimental present
generally dbs|NP associate improvement|NN motor|NN score|NN evaluation|NN
rehabilitation|NN further information|NN rehabilitation|NN Parkinson's disease|Disease
exercise|NN program|NN recommend people|NN Parkinson's disease|Disease evidence|NN speech|NN mobility|NN problem|NN improve rehabilitation|NN study|NN scarce low quality|NN regular physical exercise|NN physical therapy|NN beneficial maintain improve mobility|NN flexibility|NN strength|NN gait|NN speed|NN quality|NN life|NN exercise|NN program|NN perform supervision|NN physiotherapist|NN improvement|NN motor|NN symptom|NN mental emotional function|NN daily live|NN activity|NN quality|NN life|NN compare self-supervise exercise|NN program|NN home|NN term|NN improve flexibility|NN range|NN motion|NN people|NN experience rigidity|NN generalize relaxation|NN technique|NN gentle rock|NN found decrease excessive muscle|NN tension|NN
effective technique|NN promote relaxation|NN include slow rotational movement|NN extremity|NN trunk|NN rhythmic initiation|NN diaphragmatic breath|NN meditation|NN technique|NN gait|NN address challenge|NN associate disease|NN slowness|NN movement|NN shuffle|NN decrease arm|NN swing|NN physiotherapist|NN variety|NN strategy|NN improve functional mobility|NN safety|NN
area|NN interest|NN respect|NN gait|NN rehabilitation|NN program|NN focus|NN limit improve gait|NN speed|NN base|NN support|NN stride|NN length|NN trunk|NN arm|NN swing|NN movement|NN
strategy|NN include utilize equipment|NN pole|NN walk|NN treadmil|NN walk verbal cue|NN manual|NN visual auditory exercise|NN march pnf pattern|NN alter environment|NN surface|NN input|NN open close strengthen|NN exercise|NN show improvement|NN strength|NN motor|NN function|NN people|NN primary muscular weakness|NN weakness|NN relate inactivity|NN mild moderate Parkinson's disease|Disease
report|NN show significant interaction|NN strength|NN time|NN medication|NN taken
therefore recommend people|NN Parkinson's disease|Disease perform exercise|NN minute|NN hour|NN medication|NN best due forward flex posture|NN respiratory dysfunction|NN advance Parkinson's disease|Disease deep diaphragmatic breath|NN exercise|NN beneficial improve chest|NN wall|NN mobility|NN vital capacity|NN exercise|NN improve constipation|NN unclear exercise|NN reduce physical fatigue|NN Parkinson's disease|Disease
widely practice treatment|NN speech|NN disorder|NN associate Parkinson's disease|Disease lee|NP silverman|NP voice|NN treatment|NN speech|NN therapy|NN specifically improve speech|NN occupational therapy|NN ot|NN aim promote health|NN quality|NN life|NN help people|NN disease|NN participate daily live|NN activity|NN possible study|NN effectiveness|NN ot|NP quality|NN poor indication|NN improve motor|NN skill|NN quality|NN life|NN duration|NN therapy|NN care|NN
care|NN specialize medical care|NN people|NN serious illness|NN
goal|NN speciality|NN improve quality|NN life|NN person|NN parkinson|NN family|NN provide relief|NN symptom|NN pain|NN stress|NN illness|NN curable disease|NN treatment|NN focuse slow decline|NN improve quality|NN life|NN therefore palliative nature|NN
care|NN involve earlier later disease|NN course|NN care|NN specialist|NN help physical symptom|NN emotional factor|NN loss|NN function|NN job|NN depression|NN fear|NN existential concern|NN
offer emotional support|NN patient|NN family|NN palliative|NN care|NN serve important role|NN address goal|NN care|NN
people|NN parkinson|NN difficult decision|NN make disease|NN progress wishe|NN feed tube|NN non-invasive ventilator|NN tracheostomy|NN wishe|NN cardiopulmonary resuscitation|NN use hospice|NN care|NN care|NN team|NN member|NN help answer|NN question|NN guide|NN people|NN parkinson|NN complex|NN emotional topics|NN help make best decision|NN base value|NN
muscle|NN nerve|NN control digestive process|NN affect Parkinson's disease|Disease result constipation|NN food|NN remain stomach|NN longer period|NN normal balance diet|NN base periodical|NN nutritional assessment|NN recommend design avoid weight|NN loss|NN gain|NN minimize consequence|NN gastrointestinal dysfunction|NN disease|NN advance|NN swallow difficulty|NN dysphagia|NN appear
case|NN helpful use thicken|NN agent|NN liquid intake|NN upright posture|NN eate measure|NN reduce risk|NN choke
gastrostomy deliver food|NN directly stomach|NN possible severe case|NN
protein|NN use transportation|NN system|NN intestine|NN bloodbrain barrier|NN thereby compet access|NN taken together result|NN reduce effectiveness|NN drug|NN therefore introduce excessive protein|NN consumption|NN discourage well balance mediterranean diet|NN recommend
advance stage|NN additional intake|NN low-protein product|NN bread|NN pasta|NN recommend similar reason|NN minimize interaction|NN protein|NN taken minute|NN meal|NN time|NN regimen|NN Parkinson's disease|Disease restrict protein|NN breakfast|NN lunch|NN allow protein|NN intake|NN even|NN see unify Parkinson's disease|Disease rate|NN scale|NN global burden|NN Parkinson's disease|Disease measure life|NN year|NN inhabitant|NN data|NN 27535|NN
50575 57565|NN
Parkinson's disease|Disease invariably progress time|NN
severity|NN rate|NN method|NN known unify Parkinson's disease|Disease rate|NN scale|NN u|NP Parkinson's disease|Disease rs|NP commonly use metric clinical study|NN
modify version|NN known mds-u|NN Parkinson's disease|Disease rs|NP sometime use
older scale|NN method|NN known hoehn|NN scale|NN originally publish similar scale|NN known modify hoehn|NN scale|NN commonly use
hoehn|NN scale|NN define basic stage|NN progression|NN
motor|NN symptom|NN treate advance|NN aggressively early stage|NN disease|NN slowly later
individual|NN expect lose independent ambulation|NN average|NN year|NN bedridden year|NN uncommon find untreate people|NN nowaday
improve prognosis|NN motor|NN symptom|NN time|NN new source|NN disability|NN undesire effect|NN levodopa|NN year|NN use|NN people|NN take progression|NN time|NN symptom|NN stage|NN high dependency|NN caregiver|NN year|NN hard predict course|NN disease|NN take give individual age|NN best predictor|NN disease|NN progression|NN rate|NN motor|NN decline|NN greater impairment|NN time|NN diagnosis|NN cognitive impairment|NN frequent year|NN age|NN symptom|NN onset|NN
current therapy|NN improve motor symptom|NN disability|NN present|NN mainly relate non-motor feature|NN disease|NN nevertheless relationship|NN disease|NN progression|NN disability|NN linear
disability|NN initially relate motor|NN symptom|NN disease|NN advance|NN disability|NN relate motor|NN symptom|NN respond adequately medication|NN difficulty|NN gaitbalance problem|NN complication|NN appear individual|NN year|NN usage|NN finally year|NN people|NN disease|NN autonomic disturbance|NN sleep|NN problem|NN mood|NN alteration|NN cognitive decline|NN symptom|NN especially cognitive decline|NN greatly increase|NN disability|NN
life|NN expectancy|NN people|NN Parkinson's disease|Disease reduce mortality|NN ratio|NN twice unaffect people|NN cognitive decline|NN dementia|NN old age|NN onset|NN advance disease|NN state|NN presence|NN swallow problem|NN mortality|NN risk|NN factor|NN
hand|NN disease|NN pattern|NN mainly characterize tremor|NN oppose rigidity|NN predict improve survival|NN death|NN aspiration|NN pneumonia|NN twice common individual|NN Parkinson's disease|Disease healthy population|NN
Parkinson's disease|Disease result death|NN globally death|NN death|NN rate|NN increase average|NN time|NN epidemiology|NN death|NN Parkinson's disease|Disease person|NN 2012|NP 3762|NN
Parkinson's disease|Disease second|NN common neurodegenerative|NN disorder|NN alzheimers|NP disease|NN affect approximately people|NN globally people|NN united|NP states|NP proportion|NN population|NN give time|NN industrialize country|NN
Parkinson's disease|Disease common elderly rate|NN rise|NN year|NN age|NN population|NN mean age|NN onset|NN year|NN case|NN classify young onset|NN Parkinson's disease|Disease begin age|NN male|NN affect female|NN ratio|NN Parkinson's disease|Disease prevalent african asian ancestry|NN find|NN dispute study|NN propose common men|NN women|NN fail detect difference|NN sexe|NN number|NN new case|NN year|NN Parkinson's disease|Disease age|NN adjust rate|NN Parkinson's disease|Disease estonia|NP person|NN year|NN estonian rate|NN stable history|NN main article|NN history|NN Parkinson's disease|Disease jean-martin|NN made important contribution|NN understand|NN disease|NN propose current name|NN james|NP parkinson|NP
early source|NN egyptian papyrus|NN ayurvedic medical treatise|NN bible|NN galen|NN write|NN describe symptom|NN resemble Parkinson's disease|Disease galen|NP reference|NN unambiguously relate Parkinson's disease|Disease century|NN century|NN author|NN wrote element|NN disease|NN sylvius|NP gaubius|NP hunter|NP chomel|NP
english doctor|NN james|NP parkinson|NP publish essay|NN report|NN case|NN Parkinson's disease|Disease essay|NN Parkinson's disease|Disease describe characteristic rest|NN tremor|NN abnormal posture|NN gait|NN paralysis|NN diminish muscle|NN strength|NN way|NN disease|NN progress time|NN early made further addition|NN knowledge|NN disease|NN include gowers|NP wilson|NP erb|NP notably jean-martin study|NN landmark|NN understand|NN disease|NN advance|NN made distinction|NN rigidity|NN weakness|NN bradykinesia champion renam|NN disease|NN honor|NN james|NP parkinson|NP
frederic|NP lewy|NP describe microscopic particle|NN affect brain|NN later name body|NN konstantin|NP tretiakoff|NP report substantia nigra|NN main cerebral structure|NN affect find|NN widely accept confirm further study|NN publish rolf|NP underly biochemical change|NN brain|NN identify largely work|NN arvid|NP carlsson|NP neurotransmitter|NN dopamine|NN hornykiewicz|NN role|NN Parkinson's disease|Disease alpha-synuclein|NN found main component|NN lewy body|NN trojanowsky|NN
surgery|NN lesion|NN corticospinal pathway|NN basal ganglia|NN structure|NN treatment|NN arrival|NN levodopa|NN reduce use|NN dramatically synthesize casimir|NP funk|NP receive little attention|NN mid century|NN enter clinical practice|NN brought revolution|NN management|NN Parkinson's disease|Disease late deep brain|NN stimulation|NN introduce alim|NP louis|NP colleague|NN grenoble|NP france|NP emerge possible treatment|NN society|NN culture|NN cost|NN awareness|NN logo|NN red tulip|NN symbol|NN
cost|NN Parkinson's disease|Disease society|NN high precise calculation|NN difficult methodological issue|NN research|NN difference|NN country|NN annual cost|NN uk|NP estimate cost|NN patient|NN year|NN probably total burden|NN largest share|NN direct cost|NN come inpatient|NN care|NN nurse|NN home|NN share|NN come medication|NN substantially lower indirect cost|NN high reduce productivity|NN burden|NN caregiver|NN addition|NN economic cost|NN Parkinson's disease|Disease reduce quality|NN life|NN disease|NN caregiver advocacy|NN
april|NP birthday|NN james|NP parkinson|NP designate world|NN day|NN red tulip|NN chosen international organization|NN symbol|NN disease|NN represent james|NP parkinson|NP tulip|NP register dutch horticulturalist|NN advocacy|NN organization|NN include national parkinson|NP foundation|NN provide care|NN research|NN support|NN service|NN Parkinson's disease|Disease foundation|NN distribute research|NN nearly education|NN advocacy|NN program|NN found|NN william|NP black|NP american Parkinson's disease|Disease association|NN found european Parkinson's disease|Disease association|NN found notable case|NN main article|NN list|NN people|NN diagnose Parkinson's disease|Disease muhammad|NP ali|NP world|NN economic forum|NN davos|NP age|NN
show sign|NN parkinsonism|NN age|NN death|NN
actor|NN michael|NP j|NP
fox|NP Parkinson's disease|Disease greatly increase public awareness|NN disease|NN diagnosis|NN fox|NP embrace parkinson|NN television|NN role|NN sometime act medication|NN order|NN further illustrate effect|NN condition|NN
written autobiography|NN fight|NN disease|NN play major role|NN appear united|NP states|NP congress|NN medication|NN illustrate effect|NN disease|NN michael|NP j|NP
fox|NP foundation|NN aim develop cure|NN Parkinson's disease|Disease fox|NP receive honorary doctorate|NN medicine|NN institutet|NN contribution|NN research|NN Parkinson's disease|Disease
professional cyclist|NN olympic davis|NP diagnose young onset|NN age|NN start davis|NP phinney|NN foundation|NN support research|NN focuse quality|NN life|NN people|NN disease|NN
boxer|NN muhammad|NP ali|NP show sign|NN parkinson|NN diagnose call world|NN famous parkinson|NN patient|NN Parkinson's disease|Disease parkinsonism relate box|NN unresolve research|NN see Parkinson's disease|Disease clinical research|NN
prospect|NN significant new Parkinson's disease|Disease treatment|NN near future|NN currently active research|NN direction|NN include search|NN new animal|NN model|NN disease|NN study|NN potential usefulness|NN gene|NN therapy|NN stem|NN cell|NN transplant|NN neuroprotective agent|NN animal|NN model|NN
Parkinson's disease|Disease known occur naturally specy|NN human|NN animal|NN model|NN show feature|NN disease|NN use research|NN
appearance|NN parkinsonism|NN group|NN drug|NN addict|NN early consume contaminate batch|NN synthetic opiate|NN led discovery|NN chemical mptp|NN agent|NN cause non-human primate|NN well human|NN predominant toxin-base model|NN employ insecticide|NN herbicide|NN fungicide|NN model|NN base toxin|NN commonly use primate|NN
rodent|NN model|NN replicate various aspect|NN Parkinson's disease|Disease develop use|NN 6-hydroxydopamine|NN create model|NN Parkinson's disease|Disease rat|NN target|NN destroy neuron|NN nigrostriatal pathway|NN inject substantia nigra|NN gene|NN therapy|NN
gene|NP therapy|NN typically involve use|NN non-infectious virus|NN ie viral vector|NN adeno-associate virus|NN shuttle|NN genetic material|NN part|NN brain|NN
gene|NN use lead production|NN enzyme|NN help manage Parkinson's disease|Disease symptom|NN protect brain|NN further damage|NN clinical trial|NN use gene|NN therapy|NN Parkinson's disease|Disease important adverse effect|NN trial|NN clinical usefulness|NN gene|NN therapy|NN unknown report positive result|NN company|NN file bankruptcy|NN march|NP treatment|NN chemical compound|NN chemical structure|NN picture propose neuroprotector|NN Parkinson's disease|Disease effectiveness|NN proven
investigation|NN neuroprotection|NN forefront|NN Parkinson's disease|Disease research|NN
molecule|NN propose potential treatment|NN conclusively demonstrate reduce degeneration|NN agent|NN currently investigation|NN include monoamine oxidase|NN inhibitor|NN promitochondrial|NN creatine calcium|NN channel|NN blocker|NN growth|NN factor|NN research|NN target|NN vaccine|NN prime human immune system|NN destroy Parkinson's disease|Disease 01a|NN develop austrian company|NN affiris|NN enter clinical trial|NN human|NN vaccine|NN pass stage|NN trial|NN support stage|NN trial|NN therapy|NN main article|NN therapy|NN Parkinson's disease|Disease
early fetal porcine carotid retinal tissue|NN use cell|NN transplant|NN dissociate cell|NN inject substantia nigra|NN hope|NN incorporate brain|NN way|NN replace dopamine-produce cell|NN lost initial evidence|NN dopamine-produce cell|NN transplant|NN beneficial double-blind trial|NN date|NN indicate cell|NN transplant|NN produce long-term benefit|NN additional significant problem|NN excess release|NN dopamine|NN transplant tissue|NN lead stem|NN cell|NN transplant|NN recent research|NN target|NN stem|NN cell|NN easy manipulate stem cell|NN transplant brain|NN rodent|NN monkey|NN found survive reduce abnormality|NN nevertheless use|NN fetal stem|NN cell|NN controversial propose effective treatment|NN develop controversial way|NN use|NN induce pluripotent|NN stem|NN cell|NN taken adult|NN
transcranial magnetic stimulation|NN temporarily improve dyskinesia usefulness|NN Parkinson's disease|Disease open research|NN topic|NN nutrient|NN propose possible treatment|NN evidence|NN vitamin|NN food|NN additive|NN improve symptom|NN evidence|NN substantiate acupuncture|NN practice|NN qigong|NN tay|NN chy|NN effect|NN course|NN disease|NN symptom|NN bean|NN velvet|NN bean|NN natural source|NN levodopa|NN eaten people|NN Parkinson's disease|Disease intake|NN free risk|NN life-threaten adverse reaction|NN describe neuroleptic malignant syndrome|NN
role|NN gutbrain axis|NN gut|NN flora|NN parkinsons|NP became topic|NN study|NN 2010 start|NN work|NN transgenic mice|NN transplant|NN people|NN Parkinson's disease|Disease worse outcome|NN
study|NN human|NN show correlation|NN pattern|NN dysbiosis|NN gut|NN flora|NN people|NN Parkinson's disease|Disease pattern|NN along measure|NN severity|NN constipation|NN diagnose Parkinson's disease|Disease specificity|NN sensitivity|NN
scientist|NN hypothesize change|NN gut|NN flora|NN early site|NN Parkinson's disease|Disease pathology|NN part|NN pathology|NN
