free encyclopedia|NN jump|NN navigation|NN jump|NN search|NN Sleep paralysis|Disease john|NP henry|NP fuseli|NP nightmarejpg|NN nightmare|NN henry|NP thought depiction|NN Sleep paralysis|Disease perceive demonic visitation|NN
sleep|NN medicine|NN symptom|NN awareness|NN inability|NN move wake|NN fall asleep duration|NN couple|NN minute|NN risk|NN factor|NN obstructive sleep|NN alcohol|NN use|NN sleep|NN deprivation|NN diagnostic method|NN base description|NN differential diagnosis|NN seizure|NN periodic paralysis|NN night|NN terror|NN treatment|NN sleep|NN hygiene|NN cognitive behavioral|NN therapy|NN antidepressant|NN frequency|NN
Sleep paralysis|Disease wake fall asleep person|NN aware unable move speak episode|NN hallucinate hear feel|NN see thing|NN result fear|NN generally last couple|NN minute|NN occur single episode|NN recurrent
condition|NN occur otherwise healthy narcolepsy|NN run family|NN result|NN specific genetic change|NN condition|NN trigger sleep|NN deprivation|NN psychological stress|NN abnormal sleep|NN cycle|NN underly mechanism|NN believe involve dysfunction|NN rem|NN sleep|NN diagnosis|NN base person|NN description|NN condition|NN present similarly include atonic seizure|NN periodic paralysis|NN
treatment|NN option|NN Sleep paralysis|Disease poorly study recommend people|NN reassure condition|NN common generally serious effort|NN try include sleep|NN hygiene|NN cognitive behavioral|NN therapy|NN antidepressant|NN
people|NN experience|NN Sleep paralysis|Disease time|NN people|NN regular episode|NN male|NN female|NN affect equally Sleep paralysis|Disease describe history|NN believe play role|NN creation|NN story|NN alien abduction|NN paranormal event|NN content|NN
sign|NN symptom|NN threat|NN diagnosis|NN classification|NN differential diagnosis|NN prevention|NN treatment|NN therapy|NN therapy|NN epidemiology|NN society|NN culture|NN cultural significance|NN prime|NN literature|NN documentary|NN film|NN reference|NN external link|NN
sign|NN symptom|NN
central symptom|NN Sleep paralysis|Disease unable move awaken|NN
sound hume hiss static zap|NN buzz noise|NN report Sleep paralysis|Disease sound|NN voice|NN whisper|NN roar|NN experience symptom|NN usually accompany intense emotion|NN fear|NN panic|NN people|NN sensation|NN drage bed|NN fly numbness|NN feel|NN electric tingle|NN vibration|NN run body|NN
Sleep paralysis|Disease include hallucination|NN supernatural creature|NN suffocate terrify individual|NN accompany feel|NN pressure|NN chest|NN difficulty|NN breath|NN example|NN hallucination|NN involve menace shadowy figure|NN enter room|NN lurk window|NN subject|NN paralyze content|NN interpretation|NN hallucination|NN driven fear|NN somatic sensation|NN sexual arousal|NN rem|NN embed sleeper|NN cultural narrative|NN
rem|NN sleep|NN physiology|NN somatic symptom|NN couple awareness|NN paralyze generate variety|NN psychological symptom|NN Sleep paralysis|Disease fear|NN worry|NN aggravate catastrophic cognition|NN attack|NN activate fight-flight reaction|NN arousal|NN
consequently person|NN attempt|NN escape paralysis|NN somatic symptom|NN arousal|NN exacerbate execution|NN motor|NN program|NN absence|NN dampen feedback|NN lead heighten sensation|NN bodily tightness|NN pressure|NN even pain|NN spasm|NN limb|NN
pathophysiology|NN Sleep paralysis|Disease concretely identify theory|NN cause|NN stem|NN understand|NN Sleep paralysis|Disease parasomnia result dysfunctional overlap|NN rem|NN wake|NN stage|NN sleep|NN study|NN found individual|NN experience Sleep paralysis|Disease shorter rem|NN sleep|NN latency|NN normal shorten nrem|NN rem|NN sleep|NN cycle|NN fragmentation|NN rem|NN sleep|NN study|NN support observation|NN disturbance|NN regular sleep|NN pattern|NN instigate episode|NN Sleep paralysis|Disease fragmentation|NN rem|NN sleep|NN commonly occur sleep|NN pattern|NN disrupt seen combination|NN Sleep paralysis|Disease
major theory|NN neural function|NN regulate sleep|NN balance|NN way|NN cause different sleep|NN state|NN overlap|NN case|NN cholinergic sleep|NN neural population|NN hyperactivate serotonergic sleep|NN neural population|NN under-activate result|NN cell|NN capable send signal|NN allow complete arousal|NN sleep|NN state|NN serotonergic neural population|NN difficulty|NN overcom signal|NN sent cell|NN keep brain|NN sleep|NN state|NN normal rem|NN sleep|NN threshold|NN stimulus|NN cause|NN arousal|NN greatly elevate
normal condition|NN medial vestibular nucley|NN cortical center|NN coordinate|NN thing|NN head|NN eye|NN movement|NN orientation|NN space|NN
individual|NN sp|NN block|NN exogenous stimuly|NN mean easier stimulus|NN arouse individual|NN problem|NN regulation|NN melatonin|NN normal circumstance|NN regulate serotonergic neural population|NN typically lowest point|NN rem|NN sleep|NN inhibition|NN melatonin|NN inappropriate time|NN make impossible sleep|NN neural population|NN depolarize present stimulus|NN normally lead complete arousal|NN vestibular nucley|NN particular identify closely relate dream rem|NN stage|NN sleep|NN hypothesis|NN disorientation|NN hallucination|NN arise completely endogenous source|NN stimuly|NN
explain rem|NN wake|NN stage|NN sleep|NN overlap|NN Sleep paralysis|Disease definitely explain muscle|NN paralysis|NN experience awaken|NN effect|NN sleep|NN neural population|NN counteract characteristics|NN rem|NN sleep|NN retain awaken|NN
common consequence|NN Sleep paralysis|Disease include headache|NN muscle|NN pain|NN weakness|NN paranoia|NN
correlation|NN rem|NN sleep|NN suggest paralysis|NN complete use|NN eog trace|NN show eye|NN movement|NN possible episode|NN individual experience|NN Sleep paralysis|Disease unable speak
research|NN found genetic component|NN Sleep paralysis|Disease characteristic fragmentation|NN rem|NN sleep|NN hallucination|NN heritable component|NN parasomnia|NN lend credence|NN idea|NN Sleep paralysis|Disease genetic twin|NN study|NN show twin|NN monozygotic pair|NN identical twin|NN experience|NN Sleep paralysis|Disease twin|NN likely experience well identification|NN genetic component|NN mean sort|NN disruption|NN function|NN physiological level|NN
further study|NN conduct determine mistake|NN signal pathway|NN arousal|NN suggest theory|NN present regulation|NN melatonin|NN neural population|NN disrupt
hallucination picture|NN succubus-like vision|NN contrast|NN incubus|NN
dream|NN bad dream|NN fritz|NP
type|NN hallucination|NN link Sleep paralysis|Disease belief|NN intruder|NN room|NN presence|NN incubus|NN sensation|NN float neurological hypothesis|NN Sleep paralysis|Disease mechanism|NN usually coordinate body|NN movement|NN provide information|NN body|NN position|NN become activate actual movement|NN induce float sensation|NN
intruder|NN incubus|NN hallucination|NN highly correlate moderately correlate hallucination|NN disorientation|NN known out-of-body experience|NN differ involve threat-activate vigilance|NN system|NN threat|NN
hyper-vigilant state|NN create midbrain|NN further contribute hallucination|NN specifically emergency|NN response|NN activate brain|NN individual|NN wake feel vulnerable attack helplessness|NN intensify effect|NN threat|NN response|NN well level|NN typical normal dream|NN explain vision|NN Sleep paralysis|Disease vivid threat-activate vigilance|NN system|NN protective mechanism|NN differentiate dangerous situation|NN determine fear|NN response|NN appropriate
hyper-vigilance response|NN lead creation|NN endogenous stimuly|NN contribute perceive threat|NN similar process|NN explain hallucination|NN slight variation|NN evil presence|NN perceive subject|NN attempt suffocate press heavily chest|NN strangulation|NN neurological explanation|NN hold result|NN combination|NN threat|NN vigilance|NN activation|NN system|NN muscle|NN paralysis|NN associate Sleep paralysis|Disease remove voluntary control|NN breath feature|NN rem|NN breath|NN pattern|NN exacerbate feel|NN suffocation|NN include shallow rapid breath|NN slight blockage|NN airway|NN symptom|NN prevalent sleep|NN patient|NN
account|NN subject|NN attempt|NN breathe deeply find unable create sensation|NN resistance|NN threat-activate vigilance|NN system|NN interpret unearthly sit chest|NN threaten suffocation|NN sensation|NN entrapment|NN cause feedback|NN loop|NN fear|NN suffocation|NN increase|NN result|NN continue helplessness|NN cause subject|NN struggle|NN end sp|NN episode|NN diagnosis|NN
Sleep paralysis|Disease mainly diagnose clinical interview|NN rule|NN potential sleep|NN disorder|NN account feel|NN paralysis|NN main disorder|NN check due|NN high prevalence|NN narcolepsy|NN conjunction|NN Sleep paralysis|Disease
availability|NN genetic test|NN narcolepsy|NN make easy disorder|NN rule|NN measure|NN available reliably diagnose screen|NN munich|NP parasomnia|NP screen|NN recurrent isolate Sleep paralysis|Disease
episodes|NP Sleep paralysis|Disease occur context|NN medical condition|NN eg
episode|NN occur independent condition|NN substance|NN use|NN term isolate Sleep paralysis|Disease episode|NN frequent cause|NN clinically significant distress|NN interference|NN classify recurrent isolate Sleep paralysis|Disease
Sleep paralysis|Disease regardless classification|NN generally short minute|NN longer episode|NN document risp|NN individual|NN suffer back-to-back episode|NN Sleep paralysis|Disease night|NN unlikely individual|NN suffer
difficult differentiate cataplexy|NN brought narcolepsy|NN true Sleep paralysis|Disease phenomena|NN physically indistinguishable best way|NN differentiate note attack|NN occur
attack|NN common individual|NN fall asleep isp|NN risp attack|NN common awaken differential diagnosis|NN
similar condition|NN include
head|NN syndrome|NN potentially frighten hallucination|NN usually briefer alway loud jare paralysis|NN
nightmare|NN disorder|NN nd|NP
sleep|NN terror|NN potentially frighten rem|NN base lack|NN awareness|NN surround|NN characteristic scream|NN
panic|NN attack|NN involve fear|NN acute distress|NN lack paralysis|NN dream|NN imagery|NN
stress|NN disorder|NN include scary imagery|NN anxiety|NN limit sleep-wake transition|NN prevention|NN
circumstance|NN identify associate increase risk|NN Sleep paralysis|Disease
include insomnia|NN sleep|NN deprivation|NN erratic sleep|NN schedule|NN stress|NN physical fatigue|NN
believe genetic component|NN development|NN risp|NN high concurrent incidence|NN Sleep paralysis|Disease monozygotic twin|NN sleep supine position|NN found especially prominent instigator|NN Sleep paralysis|Disease
sleep|NN supine position|NN believe make sleeper|NN vulnerable episode|NN Sleep paralysis|Disease sleep position|NN possible soft palate|NN collapse|NN obstruct airway|NN possibility|NN regardless individual|NN diagnose sleep|NN
greater rate|NN sleep|NN supine position|NN greater amount|NN pressure|NN exert lung|NN gravity|NN
factor|NN increase risk|NN isp|NN risp avoid minor lifestyle|NN change|NN maintain regular sleep|NN schedule|NN observe good sleep|NN hygiene|NN reduce chance|NN Sleep paralysis|Disease
help subject|NN reduce intake|NN stimulant|NN stress|NN daily life|NN take hobby|NN see train psychologist|NN suggest cope mechanism|NN stress|NN
case|NN isp|NN involve genetic factorwhich|NN mean people|NN find Sleep paralysis|Disease unavoidable
meditation|NN regularly helpful prevent fragment sleep|NN occurrence|NN Sleep paralysis|Disease research|NN show long-term meditation|NN practitioner|NN spend time|NN slow wave|NN sleep|NN regular meditation|NN practice|NN reduce nocturnal arousal|NN possibly Sleep paralysis|Disease treatment|NN
medical treatment|NN start education|NN sleep|NN stage|NN inability|NN move muscle|NN rem|NN sleep|NN
people|NN evaluate narcolepsy|NN symptom|NN persist safest treatment|NN Sleep paralysis|Disease people|NN adopt healthier sleep|NN habit|NN
serious case|NN tricyclic antidepressant|NN selective serotonin|NN reuptake|NN inhibitor|NN use fact|NN treatment|NN prescribe currently drug|NN found completely interrupt episode|NN Sleep paralysis|Disease majority|NN time|NN
large trial|NN taken place|NN focus|NN treatment|NN Sleep paralysis|Disease drug|NN promise|NN case|NN study|NN trial|NN ghb|NN people|NN demonstrate reduction|NN Sleep paralysis|Disease episode|NN therapy|NN
earliest work|NN treate Sleep paralysis|Disease use culturally sensitive cognitive-behavior|NN therapy|NN call
work|NN focuse psycho-education|NN modify catastrophic cognition|NN Sleep paralysis|Disease attack|NN approach|NN previously use treat Sleep paralysis|Disease egypt|NP clinical trial|NN lack
publish psychosocial treatment|NN recurrent isolate Sleep paralysis|Disease therapy|NN isolate Sleep paralysis|Disease cbt-isp|NN manualize adherence|NN manual|NN research|NN purpose|NN intend prevent disrupt episode|NN begin self-monitor|NN symptom|NN cognitive restructure|NN maladaptive thought|NN relevant isp eg paralysis|NN permanent psychoeducation nature|NN Sleep paralysis|Disease
prevention|NN technique|NN include sleep|NN hygiene|NN preparatory use|NN various relaxation|NN technique|NN eg diaphragmatic breath|NN progressive muscle|NN relaxation|NN meditation|NN
episode|NN disruption|NN technique|NN practice session|NN apply actual attack|NN
control trial|NN cbt-isp|NN conduct prove effectiveness|NN
meditation-relaxation|NP therapy|NN publish direct treatment|NN Sleep paralysis|Disease therapy|NN base step|NN apply Sleep paralysis|Disease reappraisal|NN mean|NN attack|NN cognitive reappraisal|NN entail close eye|NN avoid panick re-appraise mean|NN attack|NN benign psychological emotional distance|NN emotion|NN regulation|NN sleeper|NN remind event|NN ie fear|NN worry|NN worsen possibly prolong inward focused-attention meditation|NN focuse attention|NN inward emotionally salient positive object|NN muscle|NN relaxation|NN relax muscle|NN avoid control breath|NN avoid attempt move
preliminary case|NN report|NN support treatment|NN randomize clinical trial|NN show effectiveness|NN epidemiology|NN
Sleep paralysis|Disease equally experience male|NN female|NN lifetime|NN prevalence|NN rate|NN derive aggregate study|NN indicate approximately general population|NN student|NN psychiatric patient|NN experience|NN episode|NN Sleep paralysis|Disease point|NN live|NN rate|NN recurrent Sleep paralysis|Disease well known 15-45 lifetime|NN history|NN Sleep paralysis|Disease meet diagnostic criteria|NN recurrent isolate Sleep paralysis|Disease survey|NN canada|NP china|NP england|NP japan|NP nigeria|NP individual|NN report experience Sleep paralysis|Disease lifetime|NN general non-white|NN appear experience|NN Sleep paralysis|Disease higher rate|NN white|NN magnitude|NN difference|NN small approximately general population|NN experience isolate Sleep paralysis|Disease likely develop year|NN age|NN
isolate Sleep paralysis|Disease commonly seen patient|NN diagnose
approximately people|NN diagnose narcolepsy|NP experience Sleep paralysis|Disease auxiliary symptom|NN majority|NN individual|NN experience Sleep paralysis|Disease sporadic episode|NN occur month|NN year|NN
individual|NN experience Sleep paralysis|Disease associate neuromuscular disorder|NN nightly episode|NN
Sleep paralysis|Disease lead individual|NN acquire condition fear|NN experience|NN worry|NN attack|NN result nighttime|NN awaken|NN fragment sleep|NN nocturnal arousal|NN hyper-alertness|NN symptom|NN paralysis|NN make person|NN likely Sleep paralysis|Disease future|NN frequent student|NN psychiatric patient|NN society|NN culture|NN century|NN version|NN füsslis|NN nightmare|NN
original definition|NN Sleep paralysis|Disease codify samuel|NP johnson|NP dictionary|NN english language|NN nightmare|NN term|NN evolve modern definition|NN
term|NN use dub british neurologist|NN
wilson|NP dissertation|NN narcolepsy|NN Sleep paralysis|Disease widely consider work|NN demon|NN specifically thought sit chest|NN sleeper|NN
old english|NN name|NN mare|NN mre|NN proto-germanic|NN mar
old norse|NN come mare|NN word|NN nightmare|NN
word|NN cognate greek mar|NP
odyssey|NN sanskrit|NN m|NN
cultural significance|NN prime|NN le|NP nightmare|NN thivier
core|NN feature|NN Sleep paralysis|Disease eg atonia clear sensorium|NN frequent hallucination|NN appear universal way|NN experience vary time|NN place|NN culture|NN term|NN identify experience|NN scientist|NN propose Sleep paralysis|Disease explanation|NN report|NN paranormal phenomena|NN ghost|NN alien visit|NN demon|NN demonic possession|NN alien|NN abduction|NN experience|NN night|NN hag|NN shadow|NN people|NN haunt|NN
night|NN hag|NN generic name|NN fantastical creature|NN folklore|NN various people|NN use explain phenomenon|NN Sleep paralysis|Disease
common description|NN person|NN feel presence|NN supernatural malevolent immobilize person|NN sit chest|NN various culture|NN various name|NN phenomenon|NN supernatural character|NN
example|NN Sleep paralysis|Disease refer pandafeche attack|NN italy|NP
italian|NN pandafeche|NN refer evil witch|NN sometime ghost-like-spirit|NN terrify cat-like creature|NN Sleep paralysis|Disease cambodian|NN known ghost|NN pushe entail belief|NN dangerous visitation|NN decease relative|NN egypt|NP Sleep paralysis|Disease conceptualize terrify jinn|NN attack|NN
jinn|NN even kill victim|NN Sleep paralysis|Disease sometime interpret space|NN alien|NN abduction|NN united|NP states|NP
scientist|NN culture|NN major factor|NN shape|NN Sleep paralysis|Disease Sleep paralysis|Disease interpret particular cultural filter|NN take greater salience|NN
example|NN Sleep paralysis|Disease fear certain culture|NN fear|NN lead condition fear|NN worsen experience|NN turn|NN lead higher rate|NN consistent idea|NN high rate|NN long duration|NN immobility|NN Sleep paralysis|Disease found egypt|NP elaborate belief|NN Sleep paralysis|Disease involve malevolent spirit-like creature|NN jinn|NN
research|NN found Sleep paralysis|Disease associate great fear|NN fear|NN impend death|NN sufferer|NN egypt|NP study|NN compare rate|NN characteristics|NN Sleep paralysis|Disease egypt|NP denmark|NP found phenomenon|NN time|NN common egypt|NP denmark|NP denmark|NP egypt|NP elaborate supernatural belief|NN Sleep paralysis|Disease experience|NN interpret odd physiological event|NN overal shorter Sleep paralysis|Disease episode|NN people|NN fear die literature|NN
various form|NN magic|NN spiritual possession|NN advance cause|NN literature|NN
century|NN europe|NP vagary|NN diet|NN thought responsible
example|NN charles|NP christma|NN carol|NP ebenezer|NP scrooge|NP attribute ghost|NN see undigest bit|NN beef|NN blot|NN mustard|NN crumb|NN cheese|NN fragment|NN underdone potato|NN
similar vein|NN household|NN offer follow advice|NN nightmare|NN
great attention|NN paid regularity|NN choice|NN diet|NN
intemperance|NP kind|NN hurtful productive disease|NN drink bad wine|NN
prejudicial fat greasy meat|NN pastry|NN
moderate exercise|NN contribute superior degree|NN promote digestion|NN food|NN prevent flatulence|NN necessarily confine sedentary occupation|NN particularly avoid apply study|NN bodily labor|NN immediately eate|NN
go bed|NN usual hour|NN frequent cause|NN night-mare|NN occasion patient|NN sleep long lie long awake night|NN
pass whole night|NN part|NN night|NN rest|NN likewise give birth|NN disease|NN occasion patient|NN succeed night|NN sleep soundly
indulge sleep|NN late morn|NN certain method|NN bring paroxysm|NN frequently return greater strength|NN acquire propensity|NN sleep time|NN irresistible
barrie|NP author|NN peter|NP pan|NP story|NN Sleep paralysis|Disease
said early boyhood|NN sheet|NN try choke night|NN describe incident|NN peter|NP pan|NP story|NN indicate familiar awareness|NN loss|NN muscle|NN tone|NN dream-like state|NN
example|NN maimie|NN asleep call|NN thatit come
feel bed|NN horns-it|NN bore darl|NN children|NN dream fly barrie|NP say horrid visible air|NN progress|NN become slow labour exactly push way|NN hostile force|NN
sometime hung air|NN peter|NP beaten fist|NN barrie|NP describe parasomnia|NN neurological symptom|NN book|NN use explore nature|NN consciousness|NN experiential point|NN view|NN documentary|NN film|NN
nightmare|NN documentary|NN discuss cause|NN Sleep paralysis|Disease seen extensive interview|NN participant|NN experience|NN re-enact professional actor|NN
synopsis|NN propose cultural meme|NN alien abduction|NN near death|NN experience|NN shadow|NN people|NN case|NN attribute Sleep paralysis|Disease
real-life horror|NN film|NN debute sundance|NP film|NN festival|NN january|NP premier theatre|NN june|NP
