free encyclopedia|NN jump|NN navigation|NN jump|NN search|NN Tonsillitis|Disease set|NN large tonsil|NN back|NN throat|NN cover yellow exudate|NN culture|NN positive case|NN pharyngitis|NN typical tonsillar|NN pronunciation|NN
infectious disease|NN symptom|NN sore throat|NN fever|NN enlargement|NN tonsil|NN trouble|NN swallow large lymph|NN node|NN neck|NN complication|NN abscess|NN duration|NN week|NN cause|NN viral infection|NN bacterial infection|NN diagnostic method|NN base symptom|NN throat|NN swab|NN rapid strep|NN test|NN acetaminophen|NN penicillin|NN frequency|NN give month|NN
Tonsillitis|Disease inflammation|NN tonsil|NN typically rapid onset|NN type|NN pharyngitis symptom|NN include sore throat|NN fever|NN enlargement|NN tonsil|NN trouble|NN swallow|NN large lymph|NN node|NN neck|NN complication|NN include abscess|NN
Tonsillitis|Disease commonly cause viral infection|NN case|NN cause bacterial infection|NN cause bacterium|NN group|NN streptococcus|NN refer throat|NN rarely bacteria|NN gonorrhoeae corynebacterium|NN influenzae|NN cause|NN typically infection|NN spread people|NN air|NN score|NN system|NN centor score|NN help separate possible cause|NN confirmation|NN throat|NN swab|NN rapid strep|NN test|NN
treatment|NN effort|NN involve improve symptom|NN decrease complication|NN acetaminophen|NN use help pain|NN throat|NN present antibiotic|NN penicillin|NN mouth|NN generally recommend allergic penicillin|NN use children|NN frequent episode|NN Tonsillitis|Disease modestly decrease risk|NN future episode|NN
people|NN sore throat|NN three-month period|NN people|NN visit doctor|NN Tonsillitis|Disease year|NN common school|NN children|NN typically occur fall|NN winter|NN month|NN majority|NN people|NN recover medication|NN people|NN symptom|NN resolve day|NN symptom|NN resolve|NN week|NN regardless present antibiotics|NN decrease symptom|NN duration|NN approximately hour|NN content|NN
sign|NN symptom|NN cause|NN diagnosis|NN treatment|NN antibiotics|NN surgery|NN reference|NN external link|NN
sign|NN symptom|NN illustration|NN compare normal tonsil anatomy|NN Tonsillitis|Disease
common sign|NN symptom|NN include
sore throat|NN red swollen tonsil|NN pain|NN swallow high temperature|NN fever|NN headache|NN tiredness|NN chill general sense|NN feel|NN unwel malaise|NN white pus-fil|NN spot|NN tonsil|NN swollen lymph|NN node|NN gland|NN neck|NN pain|NN ear|NN neck|NN weight|NN loss|NN difficulty|NN ingest swallow intake|NN difficulty|NN sleep|NN
common symptom|NN include
nausea|NN fatigue|NN stomach|NN ache|NN vomit furry tongue|NN bad breath|NN halitosis|NN voice|NN change|NN difficulty|NN open mouth|NN loss|NN appetite|NN anxietyfear|NN choke
case|NN acute Tonsillitis|Disease surface|NN tonsil|NN bright red|NN visible white area|NN streak|NN pus|NN
occur population|NN frequently due episode|NN Tonsillitis|Disease cause|NN bacteria|NN viruse|NN cause Tonsillitis|Disease
common cause|NN viral infection|NN
account sore throat|NN case|NN include adenovirus|NN influenza|NN respiratory syncytial|NN virus|NN cause virus|NN herpe|NN simplex|NN virus|NN cytomegalovirus|NN hiv|NP case|NN cause virus|NN
second|NN common cause|NN bacterial infection|NN predominant group|NN
streptococcus|NN cause throat|NN bacterial infection|NN tonsil|NN usually follow initial viral infection|NN common bacterial cause|NN include staphylococcus|NP aureus|NN resistant staphylococcus|NN aureus|NN streptococcus|NN pneumoniae|NN bordetella pertussis|NN sp|NN treponema|NN gonorrhoeae|NN
bacteria|NN implicate Tonsillitis|Disease possible role|NN acute inflammatory process|NN support clinical scientific observation|NN
normal circumstance|NN viruse|NN bacteria|NN enter body|NN nose|NN mouth|NN filter tonsil|NN tonsil|NN white blood|NN cell|NN immune system|NN destroy viruse|NN bacteria|NN produce inflammatory cytokine|NN phospholipase|NN lead fever|NN infection|NN present throat|NN surround area|NN cause inflammation|NN pharynx|NN
sometime Tonsillitis|Disease cause infection|NN spirochaeta|NN treponema|NN case|NN call angina|NN angina|NN diagnosis|NN throat|NN swab|NN
primary care|NN set|NN health|NN clinics|NN criteria|NN use determine likelihood|NN group|NN beta-hemolytic|NN infection|NN acute tonsilitis|NN need|NN antibiotics|NN treatment|NN criteria|NN weakness|NN make precise diagnosis|NN adult|NN
beside ineffective diagnosis|NN tonsilitis|NN children|NN secondary care|NN set|NN hospital|NN major criteria|NN score|NN presence|NN exudate painful neck|NN lymph|NN node|NN history|NN fever|NN age|NN year|NN absence|NN cough|NN
possibility|NN infection|NN increase|NN increase score|NN
probability|NN get score|NN score|NN
diagnosis|NN Tonsillitis|Disease confirm culture|NN sample|NN obtain swab|NN throat|NN plate|NN sheep|NN blood|NN agar|NN medium|NN
isolation|NN rate|NN increase incubate culture|NN anaerobic condition|NN use selective growth|NN media|NN
single throat|NN culture|NN sensitivity|NN 9095|NN detection|NN gabh|NN mean actually present time|NN culture|NN result|NN suggest absent
small percentage|NN false-negative result|NN part|NN characteristics|NN test|NN use possible patient|NN receive antibiotics|NN test|NN
identification|NN require hour|NN culture|NN rapid screen|NN test|NN minute|NN sensitivity|NN 8590|NN available
true infection|NN gabh|NN colonization|NN define arbitrarily presence|NN colony|NN gabh|NN blood|NN agar|NN plate|NN
method|NN difficult implement overlap|NN carrier|NN infect patient|NN
citation|NN need people|NN symptom|NN throat|NN culture|NN positive
therefore throat|NN culture|NN routinely use clinical practice|NN detection|NN
older antigen|NN test|NN detect surface|NN group|NN carbohydrate|NN
newer test|NN identify serotype|NN use nucleic acid|NN dna|NN probe|NN polymerase|NN chain|NN reaction|NN
bacterial culture|NN need perform case|NN negative rapid streptococcal test|NN increase|NN antistreptolysin|NP o|NP streptococcal antibody|NN week|NN acute infection|NN provide retrospective evidence|NN infection|NN consider definitive proof|NN infection|NN
citation|NN need
epstein|NP barr|NP virus|NN serology|NN test infectious mononucleosis|NN typical lymphocyte|NN count|NN full blood|NN count|NN result|NN blood|NN investigation|NN require hospital|NN admission|NN require intravenous antibiotics|NN increase value|NN secret phospholipase|NN alter fatty acid|NN metabolism|NN patient|NN Tonsillitis|Disease diagnostic utility|NN
use severe neck|NN pain|NN inability|NN swallow fluid|NN rule|NN mask epiglottis|NN supraglotitis|NN
routine|NN nasoendscopy|NN recommen children|NN treatment|NN
treatment|NN reduce discomfort|NN Tonsillitis|Disease include
pain|NN fever|NN reduce medication|NN paracetamol|NN warm salt|NN water|NN gargle|NN lozenge|NN warm liquid|NN
Tonsillitis|Disease cause virus|NN length|NN illness|NN depend virus|NN involve
usually complete recovery|NN made week|NN symptom|NN last week|NN
Tonsillitis|Disease cause group|NN streptococcus antibiotics|NN useful penicillin|NN amoxicillin|NN primary choice|NN consider good alternative|NN penicillin|NN acute set|NN macrolide|NN use people|NN allergic penicillin|NN
individual|NN fail penicillin|NN therapy|NN respond treatment|NN effective produce bacteria|NN
aerobic anaerobic beta|NN produce bacteria|NN reside tonsillar tissue|NN shield group|NN streptococcus|NN penicillin|NN significant difference|NN efficacy|NN various group|NN antibiotics|NN tonsilitis treatment|NN intravenous antibiotics|NN hospitalise inability|NN swallow present complication|NN
oral antibiotics|NN resume immediately person|NN clinically improve able swallow orally
recommend pain|NN treatment|NN
anti-inflammatory drug|NN nsaid|NP opioid|NN equally effective precuation|NN taken nsaid|NP cause peptic ulcer|NN disease|NN bad kidney|NN
cause respiratory depression|NN vulnerable similarly children|NN paracetamol|NN nsaids|NP use need|NN use precaution|NN mouthwash|NN use symptomatic relief|NN
helpful reduction|NN pain|NN improvement|NN symptom|NN hour|NN
oral corticosteroid|NN recommend person|NN unable swallow medication|NN surgery|NN
chronic case|NN treate tonsillectomy|NN surgical removal|NN tonsil|NN choice|NN treatment|NN children|NN modest benefit|NN tonsillectomy|NN chronic case|NN Tonsillitis|Disease prognosis|NN
advent|NN penicillin|NN major preoccupation|NN treatment|NN streptococcal Tonsillitis|Disease prevention|NN rheumatic fever|NN major effect|NN nervous system|NN sydenham|NN heart|NN
recent evidence|NN suggest rheumatogenic strain|NN group|NN beta|NN strep|NN become markedly prevalent present small pocket|NN salt|NP lake|NP city|NN usa|NP bring question|NN rationale|NN treate Tonsillitis|Disease mean|NN prevent rheumatic fever|NN
complication|NN rarely include dehydration|NN kidney|NN failure|NN due difficulty|NN swallow block airway|NN due inflammation|NN due|NN spread|NN infection|NN
abscess|NN develop lateral tonsil|NN infection|NN typically day|NN onset|NN Tonsillitis|Disease
term peritonsillar abscess|NN quinsy|NN
rarely infection|NN spread tonsil|NN result inflammation|NN infection|NN internal jugular|NN vein|NN give rise|NN spread septicaemia|NN infection|NN syndrome|NN
case|NN generally define episode|NN Tonsillitis|Disease precede year|NN episode|NN precede year|NN episode|NN precede year|NN acute case|NN palatine|NN tonsil|NN become swollen swallow impair tonsillectomy|NN perform remove tonsil|NN
patient|NN tonsil|NN remove protect infection|NN rest|NN immune system|NN
throat|NN rarely disease|NN rheumatic fever|NN occur
complication|NN extremely rare develop nation|NN remain significant problem|NN poorer nation|NN Tonsillitis|Disease associate throat|NN untreate hypothesize lead autoimmune|NN disorder|NN associate streptococcal infection|NN
