free encyclopedia|NN Venous ulcer|Disease jump|NN navigation|NN jump|NN search|NN Venous ulcer|Disease name|NN Venous ulcer|Disease Venous ulcer|Disease Venous ulcer|Disease Venous ulcer|Disease Venous ulcer|Disease Venous ulcer|Disease dorsal legjpg|NN Venous ulcer|Disease back|NN right leg|NN
Venous ulcer|Disease wound|NN thought occur due improper function|NN venous valve|NN usually leg|NN leg|NN major occurrence|NN chronic wound|NN occure leg|NN ulcer|NN case|NN Venous ulcer|Disease develop mostly medial distal leg|NN painful negative effect|NN quality|NN life|NN
exercise together compression|NN stock|NN increase|NN heal nice guideline|NN recommend venous leg|NN ulcer|NN even heal refer vascular service|NN venous duplex ultrasound|NN assessment|NN surgery|NN content|NN
sign|NN symptom|NN diagnosis|NN classification|NN distinction|NN arterial ulcer|NN differential diagnosis|NN prevention|NN treatment|NN compression|NN therapy|NN skin|NN graft|NN artificial skin|NN surgery|NN research|NN reference|NN external link|NN
sign|NN symptom|NN
sign|NN symptom|NN Venous ulcer|Disease include
moderate pain|NN improve elevation|NN arterial ulcer|NN worsen elevation|NN irregular slope edge|NN associate oedema|NN due increase hydrostatic pressure|NN contribute blanche|NN localise loss|NN skin|NN pigmentation|NN due death|NN erythrocyte|NN scare|NN harden|NN skin|NN lead invert champagne|NN bottle|NN appearance|NN leg|NN associate superficial varicose vein|NN ankle|NN flare|NN collection|NN small dark|NN engorge superficial vein|NN
Venous ulcer|Disease surgery|NN
heal process|NN chronic venous stasis|NN ulcer|NN lower leg|NN
heal Venous ulcer|Disease month|NN
exact cause|NN Venous ulcer|Disease certain thought arise venous valve|NN exist prevent blood|NN function properly cause pressure|NN vein|NN increase body|NN need pressure|NN gradient|NN artery|NN vein|NN order|NN heart|NN pump|NN blood|NN forward artery|NN vein|NN
venous hypertension|NN exist artery|NN longer significantly higher pressure|NN vein|NN blood|NN pump effectively area|NN
hypertension|NN stretch vein|NN allow blood|NN protein|NN leak|NN extravascular space|NN isolate extracellular matrix|NN ecm|NP molecule|NN growth|NN factor|NN prevent help heal wound|NN leakage|NN fibrinogen|NN vein|NN well deficiency|NN fibrinolysis|NN cause fibrin|NN build vessel|NN prevent oxygen|NN nutrient|NN reach cell|NN insufficiency|NN cause white blood|NN cell|NN leukocyte|NN accumulate small blood|NN vessel|NN release inflammatory factor|NN reactive oxygen|NN specy|NN ros|NP free radical|NN further contribute chronic wound|NN formation|NN buildup|NN white blood|NN cell|NN small blood|NN vessel|NN plug vessel|NN further contribute ischemia blockage|NN blood|NN vessel|NN leukocyte|NN responsible reflow phenomenon|NN tissue|NN fully allow blood|NN flow|NN back|NN limb|NN example|NN elevate necessary contribute reperfusion|NN injury|NN comorbidity|NN root|NN cause|NN Venous ulcer|Disease
crus|NN classic venous stasis|NN ulcer|NN occur
stasis|NN result|NN damage|NN vein|NN system|NN lower extremity|NN extreme case|NN allow pressure|NN vein|NN higher pressure|NN artery|NN
pressure|NN result|NN transudation|NN inflammatory mediator|NN subcutaneous tissue|NN lower extremity|NN subsequent breakdown|NN tissue|NN skin|NN
wound|NN distal lower extremity|NN arise cause|NN directly relate venous insufficiency|NN eg scratch|NN bite|NN burn|NN surgical incision|NN ultimately fail heal underly undiagnose venous disease|NN properly address
citation|NN need diagnosis|NN classification|NN
clinical severity|NN score|NN develop assess chronic Venous ulcer|Disease
base ceap clinical etiology|NN anatomy|NN pathophysiology|NN classification|NN system|NN develop expert|NN panel|NN
high score|NN give poor prognosis|NN distinction|NN arterial ulcer|NN
Venous ulcer|Disease tend occur medial side|NN leg|NN typically medial malleolus|NN gaiter area|NN arterial ulcer|NN tend occur lateral side|NN leg|NN bony prominence|NN
Venous ulcer|Disease typically shallow irregular slope edge|NN arterial ulcer|NN deep punch appearance|NN
Venous ulcer|Disease typically wet moderate heavy exudate|NN arterial ulcer|NN typically dry scab
skin|NN surround Venous ulcer|Disease edematous swollen evidence|NN varicose vein|NN skin|NN surround arterial ulcer|NN pale cold shiny hairless
venous arterial ulcer|NN painful arterial ulcer|NN tend painful especially elevation|NN leg|NN example|NN bed|NN
differential diagnosis|NN
leg|NN ulceration|NN result various pathologic process|NN
common cause|NN leg|NN ulceration|NN include inadequate blood|NN flow|NN oxygen|NN delivery|NN tissue|NN seen peripheral arterial disease|NN venous stasis|NN ulceration|NN
additional cause|NN include dermatose gangrenosum|NN sweet|NN syndrome|NN process|NN calciphylaxis|NN seen people|NN kidney|NN disease|NN occur medication|NN cancer|NN squamous cell|NN carcinoma|NN ulcer|NN syndrome|NN neuropathy|NN eg diabetic peripheral neuropathy|NN atypical infection|NN sporotrichosis|NN mycobacterial infection|NN
compression|NN stock|NN appear prevent formation|NN new ulcer|NN people|NN history|NN Venous ulcer|Disease treatment|NN
main aim|NN treatment|NN create environment|NN allow skin|NN grow ulcer|NN
majority|NN case|NN require find|NN treate underly venous reflux|NN
national institute|NN health|NN care|NN excellence|NN nice recommend referral|NN vascular service|NN leg|NN ulcer|NN heal week|NN heal leg|NN ulcer|NN
Venous ulcer|Disease respond patient|NN education|NN elevation|NN foot|NN elastic|NN compression|NN evaluation|NN known bisgaard regimen|NN exercise|NN together compression|NN stock|NN increase heal|NN evidence|NN antibiotics|NN administer intravenously mouth|NN useful silver|NP product|NN typically useful evidence|NN benefit|NN iodine|NN cream|NN lack|NN quality|NN evidence|NN use|NN medical grade|NN honey|NN venous leg|NN ulcer|NN
recommendation|NN dress|NN treat Venous ulcer|Disease vary country|NN
antibiotics|NN recommend use advise physician|NN due emergence|NN resistance|NN bacteria|NN antibiotics|NN
issue|NN Venous ulcer|Disease tend heal slower acute wound|NN example|NN
natural alternative|NN suitable longer term|NN use|NN exist market|NN honey|NN resin|NN salve|NN
product|NN consider medical device|NN eu|NN product|NN ce|NP mark compression|NN therapy|NN
ambulatory|NN knee|NN compression|NN counter|NN impact|NN reflux|NN venous pump|NN failure|NN
compression|NN therapy|NN use venous leg|NN ulcer|NN decrease blood|NN vessel|NN diameter|NN pressure|NN increase effectiveness|NN prevent blood|NN flow backward compression|NN use decrease|NN release|NN inflammatory cytokine|NN lower amount|NN fluid|NN leak capillary|NN therefore prevent swell prevent clote|NN decrease activation|NN thrombin|NN increase compression|NN apply use elastic bandage|NN boot|NN specifically design purpose|NN
effectiveness|NN compression|NN dress|NN improve heal clear system|NN better multilayer elastic system|NN patient|NN wear compression|NN comfortable type|NN dress|NN apply compression|NN seem matter|NN better simple low adherent|NN dress|NN recently clinical study|NN multi-functional|NN ointment|NN combination|NN compression|NN therapy|NN treatment|NN difficult-to-heal wound|NN venous leg|NN ulcer|NN
intermittent pneumatic compression|NN device|NN use clear superior simple compression|NN dress|NN
clear intervention|NN aim help people|NN adhere compression|NN therapy|NN effective research|NN need field|NN
useful add treatment|NN compression|NN stock|NN help work reduce platelet|NN aggregation|NN thrombus|NN formation|NN
gastrointestinal disturbance|NN report potential adverse effect|NN
reduce formation|NN blood|NN clot|NN reduce inflammation|NN improve heal|NN Venous ulcer|Disease taken conjunction|NN proper local wound|NN care|NN further research|NN necessary determine potential adverse effect|NN effectiveness|NN dose|NN protocol|NN treatment|NN
oral dose|NN aspirin|NN investigate potential treatment|NN option|NN people|NN Venous ulcer|Disease
2016|NP cochrane|NP systematic review|NN conclude further research|NN necessary treatment|NN option|NN confirm safe effective
oral zinc|NN supplement|NN proven effective aid heal|NN Venous ulcer|Disease research|NN necessary confirm result|NN
treatment|NN aim decrease protease|NN activity|NN promote heal|NN chronic wound|NN suggest benefit|NN remain uncertain skin|NN graft|NN artificial skin|NN
layer|NN skin|NN create animal|NN source|NN skin|NN graft|NN found useful venous leg|NN ulcer|NN
artificial skin|NN made collagen|NN culture skin|NN cell|NN use cover|NN Venous ulcer|Disease excrete growth|NN factor|NN help heal systematic review|NN found bilayer|NN artificial skin|NN compression|NN bandage|NN useful heal|NN Venous ulcer|Disease compare simple dress|NN surgery|NN
randomize control trial|NN found surgery|NN reduce recurrence|NN ulcer|NN year|NN result|NN greater proportion|NN ulcer|NN free time|NN
local anaesthetic|NN surgery|NN use thermoablation|NN laser|NN ablation|NN perforator closure|NN foam|NN sclerotherapy|NN show success|NN rate|NN heal|NN recurrence|NN heal ulcer|NN average|NN year|NN clinical improvement|NN select group|NN venous leg|NN ulcer|NN
certain dress|NN topical agent|NN effective heal venous leg|NN ulcer|NN dress|NN increase probability|NN heal|NN venous leg|NN ulcer|NN clinical trial|NN successfully perform mixture|NN sugar|NN glucose|NN powder|NN vaseline|NN
Venous ulcer|Disease costly treat significant chance|NN recur heal|NN study|NN found Venous ulcer|Disease recure year|NN heal|NN treatment|NN local anaesthetic|NN technique|NN suggest reduction|NN high recurrence|NN rate|NN possible
proper care|NN ulcer|NN get infect lead cellulitis|NN gangrene|NN eventually need amputation|NN part|NN limb|NN future|NN
topical drug|NN use treat Venous ulcer|Disease cause venous eczema|NN research|NN
current best practice|NN uk|NP treat underly venous reflux|NN ulcer|NN heal
questionable treatment|NN offer ulcer|NN heal|NN current evidence|NN support approach|NN standard care|NN
early venous|NN ulcer|NN trial|NN uk|NP nihr|NN fund randomise clinical trial|NN compare early delay endovenous treatment|NN superficial venous reflux|NN patient|NN chronic Venous ulcer|Disease open recruitment|NN october|NP
study|NN hope show increase|NN heal|NN rate|NN week|NN
research|NN university|NN surrey|NP fund leg|NN charity|NN currently look psychological impact|NN leg|NN ulcer|NN relative|NN friend|NN affect person|NN influence|NN treatment|NN
