free encyclopedia|NN jump|NN navigation|NN jump|NN search|NN White coat hypertension|Disease name|NN White coat hypertension|Disease lab|NN coat|NN scrubsjpg white coat|NN scrub|NN
White coat hypertension|Disease commonly known White coat hypertension|Disease phenomenon|NN people|NN exhibit blood|NN pressure|NN level|NN normal range|NN clinical set|NN exhibit set|NN believe phenomenon|NN due anxiety|NN experience clinic|NN visit|NN
patient|NN daytime|NN ambulatory blood|NN pressure|NN use reference|NN take account|NN ordinary level|NN daily stress|NN
problem|NN incure diagnosis|NN treatment|NN White coat hypertension|Disease
term|NN mask hypertension|NN use describe contrast phenomenon|NN patient|NN blood|NN pressure|NN normal range|NN daily live|NN isnt normal range|NN patient|NN clinic|NN set|NN content|NN
diagnosis|NN implication|NN treatment|NN reference|NN external link|NN
study|NN White coat hypertension|Disease define presence|NN define hypertensive average|NN blood|NN pressure|NN clinic|NN set|NN present patient|NN home|NN
diagnosis|NN made difficult result|NN unreliable measure|NN taken conventional method|NN detection|NN
method|NN involve interface|NN health|NN care|NN professional|NN frequently result|NN tarnish list|NN factor|NN variability|NN individual|NN blood|NN pressure|NN technical inaccuracy|NN anxiety|NN patient|NN recent ingestion|NN pressor substance|NN talk factor|NN
common measure|NN blood|NN pressure|NN taken noninvasive instrument|NN call sphygmomanometer|NN
survey|NN show primary care|NN physician|NN habitually use cuff|NN size|NN small ad|NN difficulty|NN make inform diagnosis|NN
reason|NN White coat hypertension|Disease diagnose standard clinical visit|NN
reduce eliminate automate blood|NN pressure|NN measurement|NN minute|NN quiet part|NN office|NN clinic|NN
patient|NN White coat hypertension|Disease exhibit sign|NN indicative trepidation|NN increase blood|NN pressure|NN accompany tachycardia|NN support study|NN repeatedly indicate thought|NN mild hypertension|NN result|NN clinic|NN office|NN record|NN display normal blood|NN pressure|NN unusual response|NN pressure|NN stimulus|NN
person|NN show specific characteristics|NN age|NN indicative higher susceptibility|NN White coat hypertension|Disease
blood|NN pressure|NN monitor|NN patient|NN use home|NN blood|NN pressure|NN monitor|NN device|NN increasingly use differentiate White coat hypertension|Disease experience white coat|NN effect|NN chronic hypertension|NN
mean method|NN fault|NN
daytime|NN ambulatory value|NN take account|NN stress|NN everyday life|NN taken patient|NN daily routine|NN susceptible effect|NN daily variable|NN physical activity|NN stress|NN duration|NN sleep|NN
monitor|NN found practical reliable method|NN detect patient|NN White coat hypertension|Disease prediction|NN target|NN organ|NN damage|NN
even diagnosis|NN treatment|NN White coat hypertension|Disease remain controversial
recent study|NN show home|NN blood|NN pressure|NN monitor|NN accurate 24-hour ambulatory monitor|NN determine blood|NN pressure|NN level|NN researcher|NN university|NN turku|NN finland|NP study patient|NN untreate hypertension|NN
compare patient|NN use home|NN blood|NN pressure|NN device|NN wear 24-hour ambulatory monitor|NN
researcher|NN dr|NP
said home|NN blood|NN pressure|NN measurement|NN use effectively guide anti-hypertensive treatment|NN
ad home|NN track|NN blood|NN pressure|NN convenient costly ambulatory monitor|NN
use|NN breath|NN pattern|NN propose technique|NN identify White coat hypertension|Disease
turkish study|NN consecutive patient|NN normotensive White coat hypertension|Disease mask hypertension|NN sustain hypertension|NN
even patient|NN take medication|NN sustain hypertension|NN normotensive home|NN exhibit White coat hypertension|Disease office|NN set|NN implication|NN treatment|NN
general individual|NN White coat hypertension|Disease lower morbidity|NN patient|NN sustain hypertension|NN higher morbidity|NN clinically normotensive publish trial|NN consequence|NN high blood|NN pressure|NN benefit|NN treate|NN base one-time measurement|NN clinical set|NN generally lower read|NN obtain ambulatory record|NN
debate|NN conflict idea|NN revolve feasible treat White coat hypertension|Disease conclusive evidence|NN temporary rise|NN blood|NN pressure|NN office|NN visit|NN adverse effect|NN health|NN
fact|NN cross|NN sectional study|NN show damage|NN exemplify left ventricular hypertrophy|NN hypertensive patient|NN sustain hypertensive patient|NN even allowance|NN made difference|NN clinic|NN pressure|NN believe patient|NN white coat|NN hypertension|NN require even small dose|NN antihypertensive therapy|NN result hypotension|NN careful patient|NN show sign|NN vascular change|NN eventually develop hypertension|NN
even patient|NN establish hypertension|NN well-control base home|NN blood|NN pressure|NN monitor|NN experience elevate read|NN office|NN visit|NN
